a (noun)	A Vad tycker du om Ally McBeal. 
abonnemang (noun)	Den kostar 545 med abonnemang. 
i dag (abm)	Det talas minst 140 språk i landet i dag och det har gått snabbt. 
actionfilm (noun)	Hmm, i videobutiken finns mest amerikanska actionfilmer och dåliga komedier. 
addition (noun)	Ibland använder man de mer internationella orden addition, subtraktion, multiplikation och division. 
i fredags (abm)	Vad gjorde du i fredags? 
riktig (adjective)	Jag får veta att jag är en latmask och 5 en riktig sömntuta. 
adress (noun)	KUNDEN: Vad är det för adress här? 
ringa (verb)	Ny forskning i USA visar att reaktionstiden blir betydligt sämre när du ringer vid ratten. 
advokat (noun)	Poliser, advokater och domare har i princip samma resultat. 
i går (abm)	I går kväll grälade han med Linda. 
rinna (verb)	Lennart Ja de har lyckats pumpa bort det mesta, men det verkar rinna in mer hela tiden. 
affär (noun)	Det är väl en fin affär? 
afton (noun)	En hallåman: God afton! 
i kväll (abm)	Ska vi ta en öl i kväll när vi har handlat? 
agent (noun)	Agenterna sålde biljetter och lockade folk att resa till Amerika ungefär som resebyråerna i dag lockar med semesterresor. 
ah (interjection)	D: Ah, det var en gång då mina föräldrar var där. 
i morgon (abm)	Han följer också med er och fiskar i morgon. 
i morgon bitti (abm)	Jonas: Ja, det kan vi göra, men vi måste stiga upp tidigt i morgon bitti. 
rodna (verb)	Jag törs inte säga hur jag känner för dig, sa hon hastigt och rodnade. 
rolig (adjective)	Inte så roligt, hävdar Robin Dunbar. 
i onsdags (abm)	Nej, jag var där i onsdags. 
roman (noun)	För sin senaste roman, Livläkarens besök, fick han Augustpriset 1999. 
aktiv (adjective)	Jonas Ar alla lika aktiva? 
aldrig (adverb)	Jag tycker aldrig att ett annat språk är fult tvärtom det är ofta hisnande vackert. 
ropa (verb)	ropar alla i munnen på varandra. 
ros (noun)	Rosor slår ut i den hårdaste mark 
all (prounoun)	När han kom tillbaka kunde han tala hjälpligt, men framför allt kunde han skriva och läsa. 
all (dt)	Så det är kanske mig alla insändare handlar om? 
allemansrätt (noun)	En viktig förutsättning för svenskt friluftsliv är den s k allemansrätten. 
i stället (abm)	I stället vill jag tala om mina egna erfarenheter: hur man klarar sig på andra språk än sitt eget. 
allihop (prounoun)	Jonas: Vi mår bra, allihop. 
allt (adverb)	Allt fler människor världen runt upptäcker vilken makt och vilka överraskningar som kan ligga i gester och kroppsspråk. 
rum (noun)	Den där förändringen av synen på tid och rum är jag intresserad av, säger han. 
alltid (adverb)	En smula äventyrslusta finns alltid med och äventyrslustens drivkrafter är inte obekanta. 
alltså (adverb)	De skulle alltså bli mina bröder, plastbröder. 
ibland (adverb)	Ibland kan ett av språken vara det känslomässigt starkare och framkalla kodväxling i laddade situationer. 
ambulans (noun)	Jag måste ringa efter ambulans och polis. 
amerikansk (adjective)	Men nu har den amerikanska flugan surrat in även i politikernas språk. 
ryggsäck (noun)	Han har skrivit en lång lista på ska ha i ryggsäcken. 
rysk (adjective)	Några läser ryska eller kinesiska. 
igen (adverb)	Fångvaktaren står hos Straat igen och vill prata. 
rytm (noun)	Om du inte förstår: lyssna på språkets rytm och melodi. 
igen (pl)	Alla som läste den kände igen sig, alla hade sitt eget Jante, alla kände igen dumheten, hyckleriet och skenheligheten. 
ihop med (abm)	Han är 26 år och bor ihop med Linda. 
räka (noun)	Många turister kommer till Smögen för att köpa färska räkor. 
räknesätt (noun)	De fyra räknesätten är plus, minus, gånger och delat med. 
räkning (noun)	Vem stryker, snickrar, målar och betalar räkningar? 
imorgon (adverb)	Ja, jag reser imorgon! 
in (pl)	ord som lånats in från andra språk. 
in i (ppm)	En invandrares enda chans att komma in i gemenskapen är att gifta in sig. 
annan (prounoun)	Det fulaste är när de skyller på andra. 
röka (verb)	röker eller sitter och pratar. 
ingen (dt)	Han ser allvarlig ut, tänker jag och har fortfarande ingen aning om vem han är. 
ingen (prounoun)	Och samtalen blev privatare, nu när ingen lyssnade längre. 
ingenting (prounoun)	Vi är tysta båda två men ingenting är som förut. 
använda (verb)	Tillräckligt många talar det och det används i officiella sammanhang. 
ingå (verb)	De speciella tyska anordningarna som finns runt omkring låter han ingå i språket. 
apelsin (noun)	Klara har ett äpple och en apelsin. 
apotek (noun)	Sen ligger apoteket bredvid banken. 
sak (noun)	Det var en naturlig sak att vi skulle lära oss arbeta. 
inklusive (preposition)	De packar in allt i båten, inklusive Jonas gitarr och Pelles grill. 
sallad (noun)	Åsa: En sallad och ett glas vin. 
arbeta (verb)	Det var en naturlig sak att vi skulle lära oss arbeta. 
arbete (noun)	Jag märkte ingen nytta av mitt arbete, tyckte att jag satte plåster på böldpest. 
sambo (noun)	Alla, oavsett sexuell läggning, väljer alltså att gifta sig eller att leva som sambor. 
innan (sn)	Innan hon fyllde tolv år kunde hon konversera på grekiska, latin, franska och tyska. 
arbetskamrat (noun)	En arbetskamrat: Bara bra. 
arbetslös (adjective)	Hon är arbetslös ibland. 
inom (preposition)	I själva verket varierar relationerna också inom denna cirkel på 150 personer. 
samma (dt)	Även om man behärskar flera språk så har de inte samma betydelse. 
arg (adjective)	Hon är lite arg. 
inspiration (noun)	Ibland har han inte inspiration. 
samtal (noun)	Och samtalen blev privatare, nu när ingen lyssnade längre. 
inte (adverb)	Men han var inte bara uppfinnare och affärsman. 
arton (numeral)	Det är arton grader varmt i Stockholm och det är trettio grader varmt i Madrid. 
internationell (adjective)	Teckenspråket är inte internationellt. 
internet (noun)	Jag träffade en arabisk tjej på internet, och vi chattade i timmar. 
att (ie)	att komma till anonymiteten och möjligheterna i en storstad. 
att (sn)	Finländare tycker också att svenskar pratar kringelikrokigt. 
augusti (noun)	Den börjar alltid i mitten av augusti och slutar omkring den tjugonde december. 
intressant (adjective)	Gjorde ni något intressant? 
auktion (noun)	På söndagar åker jag ofta på auktioner på landet. 
se (verb)	Han ser allvarlig ut, tänker jag och har fortfarande ingen aning om vem han är. 
intressera (verb)	Idrotts- och handikappfrågor intresserar mig mycket och min egen fond stödjer funktionshindrade som idrottar. 
av (preposition)	Ibland kan ett av språken vara det känslomässigt starkare och framkalla kodväxling i laddade situationer. 
se ut (vbm)	Han ser allvarlig ut, tänker jag och har fortfarande ingen aning om vem han är. 
sedan (preposition)	Sedan dess har över hälften försvunnit, och många fler är hotade. 
sedan (adverb)	Sedan säger han: Nu skalar du för livet. 
segelbåt (noun)	De ska låna en segelbåt av Pelles pappa. 
segla (verb)	De äter frukost och seglar till Smögen, ett litet turistparadis. 
seglingsdag (noun)	Efter den första seglingsdagen hade Daniel och hans vänner en underbar sommarnatt på den lilla ön i Göteborgs skärgård. 
invånare (noun)	I Sverige bor det 8,9 miljoner invånare. 
irakisk (adjective)	26 756 är irakiska. 
semester (noun)	På sommarlovet åkte de på semester. 
sen (adverb)	ett barn som föds långt senare än sitt/sina syskon. 
senap (noun)	Jag har glömt senapen till korven! 
sentimental (adjective)	Åsa: Äsch, var inte sentimental nu. 
it (noun)	Ja, jag jobbar med IT. 
italiensk (adjective)	Han gillar fransk mat och italienska kläder. 
sex (numeral)	Sex timmar varje förmiddag hade hon lektioner i matematik, historia, religion och filosofi. 
sexton (numeral)	Den unge Ivar var mycket duktig i skolan och tog studentexamen endast sexton år gammal. 
ja (interjection)	Ja, naturligtvis, absolut, säger Straat. 
jaa (interjection)	Expediten: Jaa ... Var det bra så? 
jadå (interjection)	Jadå, det är bra. 
shorts (noun)	nya kläder till resan, en kjol, ett par shorts och en tröja. 
jag (prounoun)	Jag skakar på huvudet och låter så förnärmad jag kan. 
sida (noun)	Man kompromissar helt enkelt lite för att göra sig förstådd på bägge sidor Atlanten. 
jaga (verb)	Han jagar eller fiskar 3 minuter i veckan. 
jaha (interjection)	Läraren: Jaha ... Någon annan? 
siffra (noun)	Siffra 10 är en kontrollsiffra. 
sig (prounoun)	Han åkte ner till mitt hemland och satte sig på skolbänken. 
bada (verb)	Ibland badade vi och simmade efter kanoten, och ibland fiskade vi. 
januari (noun)	Orvar är alltså född i januari. 
badrum (noun)	Till höger finns ett litet badrum med toalett och dusch, och till vänster har han ett litet kök. 
japansk (adjective)	Jag talar svenska, engelska, japanska och koreanska. 
bagage (noun)	Å: Hur kunde de bära sitt tunga bagage? 
jaså (interjection)	Jaså, här i Stockholm? 
javisst (interjection)	Javisst ja !Är hon ogift? 
jazz (noun)	Han älskar klassisk musik och jazz. 
baka (verb)	Hon står och bakar i köket. 
jeans (noun)	I går tvättade Han köpte också ett par jeans. 
bakom (preposition)	Men vi får inte glömma bort att bakom den öppna dörren kan det finnas ett halt golv. 
jo (interjection)	Jo, att en tupplur på trettio minuter kan kompensera tre timmars nattsömn. 
jobb (noun)	Under åren har jag fått vänner på olika håll i världen, och jag har internationella engagemang utanför själva jobbet. 
jobba (verb)	Inte många av oss jobbar inom lantbruket. 
jodå (interjection)	Lasse: Jodå, jag klagar inte. 
sista (adjective)	Det tionde och sista är hans. 
sitta (verb)	Det sitter så djupt att man vill göra ett gott intryck. 
bank (noun)	Han går inte till banken, för den är stängd nu. 
journalist (noun)	Klara vill bli journalist, när hon blir stor. 
ju (adverb)	Vi har ju numera tillgång till bokstavligen hela världen varje språk har åtminstone någon representant i Sverige. 
sju (numeral)	i Graceland, drömmen om att ta en bit av Memphis till Östmark föddes för sju, åtta år sedan. 
sjuk (adjective)	Och jag ligger hemma och är sjuk! 
bara (adverb)	Men han var inte bara uppfinnare och affärsman. 
sjukhus (noun)	Jag jobbar på ett sjukhus. 
jul (noun)	Vi ses i jul! 
sjunga (verb)	Inne i lägenheten böljar de sjunga, först lite falskt men sedan låter det riktigt vackert: 
barn (noun)	Visar bilder på barnen. 
barnbarn (noun)	De älskar sina barnbarn. 
sjutton (numeral)	Jag är gift med Ellen och vi har en stor kille på sjutton och en liten tjej på fem. 
juli (noun)	Har ni någon billig resa till Kreta en vecka i juli. 
själv (adjective)	Han undrade själv många gånger. 
barnprogram (noun)	Jag sitter och tittar på barnprogram på tv. 
juni (noun)	Vårterminen varar till den nionde- tionde juni. 
sjö (noun)	Det är en sjö. 
basket (noun)	Tja, spelar basket, går ut och dansar och så där ... 
just (adverb)	Battenbach är nöjd, just så har han föreställt sig det. 
just det (inm)	C: Ja, just det. 
just nu (abm)	Själv har han just nu knappt 20 000. 
bearnaisesås (noun)	I dag äter Renate en stor biff med pommes frites och bearnaisesås. 
jämn (adjective)	Är det en någorlunda jämn fördelning mellan substantiv och verb i texten? 
järnmalm (noun)	Där finns en stor gruva där man bryter järnmalm. 
skicka (verb)	Jag tror att barnen upplever att de blir mindre viktiga än telefonsamtalet eller mejlet som jag måste skicka omedelbart. 
skida (noun)	Varje vinter åker jag till Jämtland och åker skidor. 
behöva (verb)	Det behöver dock inte vara själva risken som lockar, utan upplevelsen. 
bekant (adjective)	Han träffar en bekant. 
skilja (verb)	Andra kännetecken sensationssökarna har är att de i högre utsträckning än andra skiljer sig, eller lever ensamma. 
skina (verb)	Här skiner solen ... men 
jättetrevlig (adjective)	Han var jättetrevlig, men slarvig. 
berg (noun)	Att bestiga världens högsta berg är en risk i sig. 
skjorta (noun)	affären just nu säljer skjortor extra billigt. 
kaffe (noun)	Då dricker vi te eller kaffe, 
sko (noun)	Mamma tog av skorna med en trotsig blick. 
skog (noun)	Sverige det är rena gator, gröna parker, rika naturtillgångar: skogar, järn, älvar. 
kafferast (noun)	(Hon har en kafferast klockan tre.) 
kafé (noun)	Vi har en riktig turnering på boulebanan och efteråt tar vi en kopp kaffe på kaféet. 
bestämma sig (vbm)	Marie bestämde sig för att hennes doktorsavhandling skulle handla om uranets förmåga att ge energi. 
skoj (adjective)	Det blir skoj att jobba. 
besök (noun)	Men hon har visst redan besök! 
kall (adjective)	Utan den naturliga växthuseffekten hade det varit 35 grader kallare vid jordytan än vad det är i dag. 
skola (verb)	De skulle alltså bli mina bröder, plastbröder. 
skola (noun)	Barn tillbringar en stor del av sin dag i skolan eller förskolan där allt sker på landets språk. 
betala (verb)	Han blev livrädd och betalade våra hamburgare och våra cigarretter i flera månader. 
kam (noun)	Tja ... en mobiltelefon, en karta, ett paket tuggummi, en kam, en ordbok, en penna och ett suddgummi. 
kamera (noun)	Vi mäter med radar på de mest olycksdrabbade vägarna och även med kamera. 
betyda (verb)	Det märkliga med jiwarli är att en mening betyder exakt samma sak även om man kastar om ordens ordning. 
skolgård (noun)	Ta era jackor och sedan går vi tillsammans lugnt och sansat ut på skolgården. 
bibliotek (noun)	Biblioteket ligger vid Stortorget mitt emot parken med kyrkan. 
kanelbulle (noun)	Nu ska jag gå hem och mikra några kanelbullar. 
biff (noun)	Daniel: Jag tar biff och stekt potatis och en öl. 
bil (noun)	Men i en bil och med rusdrycker skvimpandes innanför pannbenet, är det inte längre mitt huvud det handlar om. 
kanot (noun)	D: Vi och vår kanot. 
bild (noun)	Visar bilder på barnen. 
kanske (adverb)	Men det beror kanske på att den handlar om två människor som råkade bli mina föräldrar. 
biljett (noun)	Har du köpt alla biljetter? 
billig (adjective)	Naturligtvis är det billigare (och trevligare!) 
kapitel (noun)	Han skriver ungefär ett kapitel varje dag. 
skratta (verb)	Jag förklarade att det handlade om smileys och vi skrattade åt saken. 
skriva (verb)	När han kom tillbaka kunde han tala hjälpligt, men framför allt kunde han skriva och läsa. 
bio (noun)	Det är en ganska liten bio. 
bioannons (noun)	De tittar i tidningen på bioannonserna. 
skrivbord (noun)	D: Jag vid mitt skrivbord. 
karies (noun)	Sara: Jaha, jag forskar också, om karies. 
bjuda (verb)	Sitt tråkiga Ikea-möblerade radhus med Billy-bokhyllor, Klippan-soffor och diverse trasmattor fann hon inte intressant nog att bjuda Panthea till. 
karta (noun)	Han gjorde om verkligheten och vred på kartan tills bilden passade hans idé. 
bland annat (abm)	Vitamin D verkar vara mycket effektiv i att reglera celltillväxt och därmed förhindra bland annat tumörbildning. 
kassa (noun)	Nej, då måste du gå till kassan. 
bli (verb)	Men det beror kanske på att den handlar om två människor som råkade bli mina föräldrar. 
kasta ankar (vbm)	Mitt på dagen kastar de ankar * vid en ö, badar och solar. 
katastrof (noun)	Det är en katastrof. 
blomma (noun)	Hennes blus är också vit, men västen är blå med ljusblåa blommor. 
katt (noun)	Klara: Katter är inte rädda för mörker. 
blond (adjective)	Jag är väl blond? 
blå (adjective)	Du är ju alldeles blå om munnen! 
kemi (noun)	Då delar Sveriges kung ut Nobelpriset i fysik, kemi, medicin, litteratur och ekonomi. 
skämta (verb)	Jag skämtar bara med dig. 
bo (verb)	Alla bor i en by som vid den senaste folkräkningen hade 191 invånare. 
kille (noun)	Han håller föredrag i skolor och på arbetsplatser och leder kurser för både killar och tjejer. 
skärgård (noun)	Efter den första seglingsdagen hade Daniel och hans vänner en underbar sommarnatt på den lilla ön i Göteborgs skärgård. 
bok (noun)	Människor refererade till Jantelagen utan att ha läst boken eller ens veta vem Sandemose var. 
bokhylla (noun)	I bokhyllan har han massor av böcker och saker. 
kinesisk (adjective)	Några läser ryska eller kinesiska. 
kiosk (noun)	(Man kan också köpa frimärken i affärer och kiosker.) 
skådespelerska (noun)	Lisa Sylvén är skådespelerska. 
kjol (noun)	nya kläder till resan, en kjol, ett par shorts och en tröja. 
skåp (noun)	Bosse behöver en matta, ett skåp och några lampor. 
klaga (verb)	Lasse: Jodå, jag klagar inte. 
skön (adjective)	Ack, Värmeland du sköna 
klar (adjective)	Det är inte längre klart var samhället slutar och var det privat kommersiella börjar. 
klara (verb)	I stället vill jag tala om mina egna erfarenheter: hur man klarar sig på andra språk än sitt eget. 
bord (noun)	Vid bordet rådde dödstystnad bland barnen och fadern talade mycket lite. 
sköta sig (vbm)	Det är så skönt att sköta sig själv utan att föräldrarna lägger sig i vad man gör. 
klass (noun)	Man börjar första klass vid sju års ålder och slutar vid 16 års ålder. 
borsta (verb)	Varje morgon vaknar jag, bäddar sängen duschar och borstar tänderna. 
borta (adverb)	Helena: Där borta växer det blåbär, ser jag! 
klassisk (adjective)	Han älskar klassisk musik och jazz. 
klassrum (noun)	De går tillsammans till klassrummet. 
bosnisk (adjective)	43 010 är bosniska och 
bra (adverb)	Han trivdes bra i drottningens sällskap, men han trivdes inte lika bra i Sverige. 
bra (adjective)	Barnen blev bättre på maori än sina föräldrar. 
klippa (noun)	De har en underbar kväll på en klippa. 
bredvid (preposition)	Sen ligger apoteket bredvid banken. 
brev (noun)	Han skriver då och då brev till mig. 
klocka (noun)	Man låter ju som en klocka. 
klok (adjective)	Det är inte klokt att hyrorna höjs två gånger om året. 
slut (adjective)	Äntligen är skoldagen slut, och eleverna får gå hem, många fortfarande med glitter i håret. 
sluta (verb)	Bartendern möter sina kunder när de flesta har slutat sina jobb. 
bro (noun)	Gå till vänster vid trafikljusen och över bron. 
broder (noun)	Bjud oss på McDonald ' s, annars pratar vi med hennes bröder! 
bror (noun)	De skulle alltså bli mina bröder, plastbröder. 
broschyr (noun)	Turisten: Har ni någon karta och några broschyrer? 
släkt (noun)	Kungen tillhör en internationell släkt. 
klä på sig (vbm)	Sedan tog han fram rena underkläder och strumpor och en ny, vit skjorta och klädde på sig. 
bruka (verb)	Per Albin Hansson * skapade folkhemmet och Ingvar Kamprad möblerade det, brukar det heta. 
kläder (noun)	Då upptäcker han att han står där utan kläder, spritt naken. 
slå (verb)	Man kanske skulle slå ett slag för tvättstugan i alla fall. 
brygga (noun)	De sitter på bryggan och tittar på folk och båtar medan de äter räkorna. 
bryta (verb)	Däremot tycker folk inte att det är acceptabelt att bryta mot 30-kilometersgränser, säger Lars Åberg. 
km (noun)	Sveriges yta är 450 000 km 2. 
bröd (noun)	Det som absolut var förbjudet var kolhydrater och han fick avstå från öl, bröd, mjöl och socker. 
smal (adjective)	Där finns berg, stora skogar och smala sjöar. 
kock (noun)	Två av hans kusiner ska hjälpa till, och en svägerska ska vara kock. 
bukett (noun)	29 kronor för en bukett. 
bulle (noun)	äter en bulle och ringer hem. 
koka (verb)	D: Ja, han kan koka ägg och laga kaffe. 
buss (noun)	Ta tåg, buss, tunnelbana och spårvagn i stället för bilen. 
bussbiljett (noun)	— Jag vill ha en bussbiljett också, tack. 
kolla (verb)	Nu sitter han i soffan och kollar sin lista. 
kollega (noun)	Han kör in på en taxiparkering och hans kollega Gunilla kör in efter honom. 
byta (verb)	Personligheten växlar när man byter språk, och varje aspekt är autentisk på sitt sätt. 
komedi (noun)	Hmm, i videobutiken finns mest amerikanska actionfilmer och dåliga komedier. 
byta om (vbm)	Hon duschar, ringer till en väninna och byter om. 
komma (verb)	att komma till anonymiteten och möjligheterna i en storstad. 
komma fram (vbm)	Det forskarna nu kommit fram till det har jag känt på mig i hela mitt liv. 
byxa (noun)	Eva: Jag har inte heller råd, men jag tänker köpa ett par byxor i alla fall. 
komma för (vbm)	Emil kommer för sent till skolan. 
komma hem (vbm)	Vad är det första du gör när du väl kommer hem efter en lång och ansträngande resa? 
bädda (verb)	Vem tvättar, handlar mat, syr, tvättar fönster, dammsuger, lagar mat, diskar, bäddar och städar hemma? 
komma ihåg (vbm)	Kommer du ihåg honom? 
komma in (vbm)	En invandrares enda chans att komma in i gemenskapen är att gifta in sig. 
bära (verb)	För en amerikan är vi lika som bär. 
komma sig (vbm)	Mormor och morfar kommer till oss då. 
komma tillbaka (vbm)	1988 röstades partiet in i riksdagen, 1991 åkte det ur för att sedan komma tillbaka 1994. 
båda (prounoun)	Där började båda på en konstskola. 
båt (noun)	Kanske Hassan och jag åker ut med båten och fiskar på eftermiddagen. 
börja (verb)	Därigenom fick vi ett enhetligt svenskt skriftspråk som började spridas över landet. 
början (noun)	I början av 1990-talet kom de första mobila telefonerna som var tunga bananliknande jättetelefoner. 
smörgås (noun)	Han dricker en kopp kaffe och äter en smörgås till frukost. 
ca (adverb)	Ibn Sina (ca 980-1037) föddes i nuvarande Uzbekistan. 
cancer (noun)	Jag forskar om cancer. 
kompis (noun)	Så jag experimenterade med språket tillsammans med mina kompisar. 
snar (adjective)	Jag ser fram emot att höra av er inom en snar framtid. 
chef (noun)	Lasses chef: God middag! 
snickra (verb)	Vem stryker, snickrar, målar och betalar räkningar? 
konferens (noun)	Konferensens deltagare bor på hotell. 
cigarett (noun)	Ett paket cigaretter och en kvällstidning. 
snygg (adjective)	Hanna tycker att Emil är snygg och hon tänker ofta på honom. 
cigarrett (noun)	En dag köper Alexander, 12 år, ett paket cigarretter och kvällstidningar åt sin får. 
cirka (adverb)	Det är en stor kommun till ytan, men bara cirka 25 000 bor där. 
snö (noun)	), men på vintern är det mörkt och kallt, fast snön lyser upp landskapet. 
snöa (verb)	a (av substantiv) snöa 
civilingenjör (noun)	Hassan är civilingenjör och han har nyss blivit pappa till Fabian. 
konsert (noun)	Ska vi gå på konserten med Kromixa i morgon? 
cykel (noun)	Numera vet man att hälften av våra drömmar sker i REM-sömnen och hälften i något annat steg i cykeln. 
d (noun)	Vid brist på vitamin D kan skelettet lakas ur och benskörhet eller benuppmjukning kan bli följden. 
dag (noun)	I genomsnitt ägnar svenska kvinnor 81 minuter och svenska män 64 minuter per dag åt Facebook. 
dagbok (noun)	Hon skriver dagbok i köket klockan ett på natten. 
konstnär (noun)	På en resa i England på 70-talet träffade Anna en konstnär. 
dagis (noun)	När Klara kommer till dagis, måste hon ta av stövlar, sockor, vantar, jacka, byxor, halsduk och mössa. 
dammsuga (verb)	Vem tvättar, handlar mat, syr, tvättar fönster, dammsuger, lagar mat, diskar, bäddar och städar hemma? 
dans (noun)	På lördagarna var det dans i Folkets Hus. 
dansa (verb)	Tja, spelar basket, går ut och dansar och så där ... 
soffa (noun)	Då sover Bosse på soffan. 
soffbord (noun)	En matta ligger på golvet framför soffan, och på mattan står ett soffbord. 
dansk (adjective)	Men titta, här finns en dansk film som båda vill se! 
danskurs (noun)	Hon har en danskurs mellan tio och tolv. 
sol (noun)	På vintern är solens strålar för svaga för att kunna bilda något vitamin i huden. 
sola (verb)	Mitt på dagen kastar de ankar * vid en ö, badar och solar. 
kontokort (noun)	* Jag har glömt att skriva upp kontokortet! 
kontor (noun)	Varje förmiddag sitter jag på kontoret och jobbar. 
dataspel (noun)	Jag vill ha det där dataspelet också. 
kontrollsiffra (noun)	Siffra 10 är en kontrollsiffra. 
dator (noun)	Sedan diskar han, och klockan nio sitter han vid datorn. 
de (prounoun)	Det fulaste är när de skyller på andra. 
december (noun)	I december går solen aldrig upp här. 
kopp (noun)	Jag dricker en kopp kaffe, 
som (ha)	Detta förvånade undersökarna, precis som det har förvånat Anna Berg och Arne Damström. 
dela (verb)	När båda tar ut föräldraledighet delar man varandras liv på ett annat sätt. 
dela ut (vbm)	Det är kungen som delar ut prisen, och efter prisceremonin har man en stor fest i Stadshuset i Stockholm. 
deltagare (noun)	Konferensens deltagare bor på hotell. 
den (prounoun)	Men det beror kanske på att den handlar om två människor som råkade bli mina föräldrar. 
den (dt)	Att det var så stod tämligen klart vid hennes död den 31 augusti 1997. 
den där (pnm)	Vad är det där för djur? 
sommar (noun)	De gräver och planterar och krattar löv och väntar på sommaren. 
den här (pnm)	Ät det här hållet. 
densamma (prounoun)	Powerwalk är detsamma som en mycket snabb promenad. 
kort (noun)	D: Här är fler kort från din examen! 
sommarjobb (noun)	Så det är bra att ha ett sommarjobb också. 
design (noun)	Akinori arbetar inte i Sverige, han studerar design här. 
sommarkläder (noun)	Maja Alla sommarkläderna och lådorna med minnen från när barnen var små har blivit blöta och antagligen helt förstörda. 
designhögskola (noun)	Akinori: Jag pluggar på Designhögskolan. 
sommarnatt (noun)	Efter den första seglingsdagen hade Daniel och hans vänner en underbar sommarnatt på den lilla ön i Göteborgs skärgård. 
sommarrea (noun)	Elin: Då kan du handla på sommarrean. 
korv (noun)	Jag vill ha tio korvar. 
det är lugnt (inm)	Hanna: Det är lugnt. 
kosta (verb)	Den kostar 295 kronor, men den är inte lika bra. 
somna (verb)	1 Sundsvall somnar hon. 
dialog (noun)	En typisk dialog vid en kiosk: 
son (noun)	När min son tog studenten bestämde han sig för att lära sig grekiska. 
kr (noun)	1954 köpte vi en Saab för 7 500 kr. 
kram (noun)	Stora pussar och kramar! 
krama (verb)	Sedan kramar han om gaspadin Medvjedev. 
diplom (noun)	D: Ni och era diplom. 
sortera (verb)	Jag sorterade brev och vykort, hämtade paket, städade och spelade kort på rasterna. 
direkt (adverb)	Äventyret ligger inte i kostnaden utan i utmaningen, men visst: Jetski över Atlanten-expeditionen var ju inte direkt gratis. 
sova (verb)	De verkar sova lätt och öppnar ett öga då och då för att kolla vad som händer. 
disk (noun)	Jonas: Hon håller på och diskar. 
diska (verb)	Sedan diskar han, och klockan nio sitter han vid datorn. 
disko (noun)	Sedan går de på disko och dansar. 
kreditkort (noun)	Lisa bjuder Marie- Louise och betalar med kreditkort. 
sovrum (noun)	I sovrummet fmns det tre sängar, två garderober, en väckarklocka och en liten radio. 
diskutera (verb)	Då sitter vi och diskuterar. 
division (noun)	Ibland använder man de mer internationella orden addition, subtraktion, multiplikation och division. 
spara (verb)	Varje månad sparar hon 1 000 kr, och sedan åker hon utomlands på semestern. 
dollar (noun)	Jag skulle vilja växla 100 dollar till kronor. 
spela (verb)	När Jack Butler fortfarande levde spelade Peter Austin in deras samtal. 
krona (noun)	Dessutom hade jag som mål att ta för runt 1 000 kronor i veckan. 
dotter (noun)	Några år senare omkom Pierre i en olycka och Marie stod ensam med två döttrar. 
sport (noun)	Orientering är en mycket populär sport i Sverige. 
dricka (verb)	Pappan blir olycklig och börjar dricka. 
springa (verb)	Om du inte gillar att jogga eller springa är det här den perfekta motionen. 
kul (adjective)	Det var kul att träffas. 
dryck (noun)	Daniel, Jonas och Pelle har köpt drycker, grillkorv och bröd. 
drömma (verb)	Men här sitter jag och drömmer! 
språk (noun)	ord som lånats in från andra språk. 
du (prounoun)	Sedan säger han: Nu skalar du för livet. 
kund (noun)	Kunden: Nej, det var bra så. 
dubbelrum (noun)	Peter: Det är ett stort dubbelrum med dusch och toalett och hotellet har en fin pool. 
kung (noun)	Men många italienare hävdar att kungen stal den och vill att Frankrike ska lämna tillbaka den till Italien. 
kunna (verb)	Innan hon fyllde tolv år kunde hon konversera på grekiska, latin, franska och tyska. 
dusch (noun)	Varje morgon vaknar jag, bäddar sängen duschar och borstar tänderna. 
duscha (verb)	Hon duschar, ringer till en väninna och byter om. 
dvd (noun)	Ska de hyra en dvd? 
kurs (noun)	Varje onsdag går jag på kurs. 
dynamit (noun)	Uppfinningen av dynamit gjorde Nobel rik. 
dynamitfabrik (noun)	Gå till Nobelmuseet eller besök Vinterviken och se Nobels dynamitfabrik. 
dyr (adjective)	Det är inte så dyrt. 
kusin (noun)	Två av hans kusiner ska hjälpa till, och en svägerska ska vara kock. 
spännande (adjective)	Han brukar berätta så spännande saker om sitt land att vi kan sitta och prata i timmar. 
där (adverb)	Vad är det där för djur? 
där (ha)	där ingen hör vad du sjunger 
kvar (adverb)	M: Har du några pengar kvar? 
därför (adverb)	Paren vänder sig därför till länder som USA och Indien. 
därför (ha)	därför han ock, därför han ock vin planterat har. 
kvart (noun)	Kvart i åtta har vi en paus. 
kvinna (noun)	I genomsnitt ägnar svenska kvinnor 81 minuter och svenska män 64 minuter per dag åt Facebook. 
då (adverb)	Det var då hon blev författare. 
stackars (adjective)	Så brukade en förvirrad stackars gumma på fattighuset säga därhemma i Småland. 
då (ha)	Det var på den tiden då de två viktigaste skolböckerna var Bibeln och skolatlasen. 
stad (noun)	Tusentals människor från vitt skilda länder befolkar förorterna runt de större städerna i Sverige. 
dålig (adjective)	Man har sagt att hon log med stängd mun för att hon hade dåliga tänder. 
dö (verb)	All ungdomlig cred jag någonsin känt, inbringat eller byggt, dog. 
död (noun)	Håller vi sakta på att konsumera oss till döds? 
kvitto (noun)	Här är kvittot och tjugonio kronor tillbaka. 
kväll (noun)	Mammas ord var i själva verket mer en förmaning än en önskan om en trevlig kväll. 
stadshus (noun)	På kvällen äter 1 200 gäster en fin middag i Stockholms stadshus. 
kvällskurs (noun)	Jag läser svenska på en kvällskurs. 
kvällstidning (noun)	Varje kväll lagar jag mat, äter med familjen, tittar på teve, diskar och läser kvällstidningen ... 
e-post (noun)	Men jag brukar läsa tidningen och skriva e-post till mina kompisar. 
stanna (verb)	Medan testgruppen gjorde dessa saker mättes deras reaktionstider när de bromsade in eller måste stanna för rött ljus. 
efter (preposition)	Han startade ett eget företag där och efter fem år flyttade familjen efter honom. 
starta (verb)	Fredrik: Jag ... har startat en egen liten firma. 
eftermiddag (noun)	Varje eftermiddag har jag kafferast. 
efternamn (noun)	Kim heter jag i efternamn. 
efterrätt (noun)	Vill du ha kaffe nu eller vill du ha efterrätt först? 
station (noun)	Sedan springer han till stationen. 
eftersom (sn)	De tre språken valdes eftersom de till betydande del har olika vokalsystem. 
känna (verb)	Den kändes som en stor lättnad och spred sig snabbt i samhällets alla skikt. 
egentligen (adverb)	Det är egentligen mest en fråga om tid och om att vilja. 
stava (verb)	Hur stavar du det? 
ekonomi (noun)	Sedan ska hon avsluta sina studier i internationell ekonomi. 
steka (verb)	Solen stekte, och luften var som kristall. 
sten (noun)	KLARA: Vi lekte på dagis och jag ramlade ner från en sten. 
kök (noun)	Straat blir åter kommenderad till köket, i Battenbachs ögon finns en belåten glimt, Battenbach låter ingen dö. 
sticka (verb)	Morfar: Mormor sitter och stickar en ... 
eller (conjunction)	Barn tillbringar en stor del av sin dag i skolan eller förskolan där allt sker på landets språk. 
stiga upp (vbm)	Hon vaknar klockan sju, och halv åtta stiger hon upp och lagar frukost. 
köpa (verb)	En lite billigare prislapp sattes på honom då italienska Milan köpte honom för 225 milj i augusti 2010. 
elva (numeral)	ELLEN: Jo, jag vill att du kommer hem klockan elva i morgon. 
kör (noun)	På måndagar sjunger jag alltid i en kör. 
köra (verb)	Den här studien visar orsaker till att bilförare distraheras och kör sämre. 
en (dt)	Att det var så stod tämligen klart vid hennes död den 31 augusti 1997. 
en del (pnm)	En del böcker köpte hon men en del togs som krigsbyte av svenska soldater i kriget. 
en gång (abm)	Än en gång riskerar han att avslöjas. 
en gång i veckan (abm)	Så där * en gång i veckan. 
en gång till (abm)	Åh förlåt, en gång till. 
stol (noun)	Vår affärsidé är lika enkel som genial: den bygger på att du tar med dig stolen själv. 
laga (verb)	Vi kunde ändå inte hjälpa Janne att laga punkteringen. 
engelsk (adjective)	Det gör föräldrar vare sig de talar svenska, engelska eller ryska. 
engelska (noun)	Han mötte det han hellre säger på engelska än förklarar på svenska, the spirit of place. 
stor (adjective)	I en katalog fick de sig presenterat ett stort urval av villiga donatorer. 
lagom (adjective)	Solen skiner, det är lagom vind och 18 grader i vattnet. 
enkel (adjective)	Vår affärsidé är lika enkel som genial: den bygger på att du tar med dig stolen själv. 
storhandla (verb)	Varje lördag storhandlar jag. 
ensam (adjective)	Han ensam bestämmer över ord och regler. 
lampa (noun)	Jag sparar energi genom att alltid släcka lamporna i rum som jag inte är i. 
land (noun)	Paren vänder sig därför till länder som USA och Indien. 
landskap (noun)	Skåne, nr 4, är också ett landskap, men det ligger i södra Sverige. 
strax (adverb)	Strax efter åtta går de på en restaurang och äter. 
lapp (noun)	Skriv nya ord på lappar med svenska på en sida och ditt språk på andra sidan. 
ett par (pnm)	Ett par minuter senare avslutar hon samtalet och frågar vad dottern ville. 
lax (noun)	Ja, laxen är fin. 
strutsfarm (noun)	Min morbror flyttade till Nya Zeeland för tio år sedan och startade en strutsfarm där. 
stryka (verb)	Vem stryker, snickrar, målar och betalar räkningar? 
ledig (adjective)	Nej, jag är ledig. 
examen (noun)	D: Här är fler kort från din examen! 
lektion (noun)	På tisdag har vi lektion mellan 11 och 12. 
expedit (noun)	Jag frågar expediten på varuhuset. 
experiment (noun)	Ett av experimenten slutade i katastrof och flera personer dog. 
experimentera (verb)	Där började de experimentera med nitroglycerin. 
leva (verb)	När Jack Butler fortfarande levde spelade Peter Austin in deras samtal. 
studera (verb)	Fångvaktaren ser på honom och frågar: Vad var det du studerade då? 
extra (adverb)	Anders Jag går egentligen på Socialhögskolan, men jobbar extra här ett par nätter i veckan. 
studiemedel (noun)	Studiemedel, heter det så? 
fabrik (noun)	Jag blev farfar och fyllde 65 år och slutade på fabriken. 
stuga (noun)	Vi har en stuga i Halland. 
ligga (verb)	Det ligger i Roms gamla stadsdel och är numera ett tavelmuseum. 
stunda (verb)	Lördag stundar helgen till. 
lik (adjective)	Ett år efter Koreakrigets utbrott utfärdades ILO-konventionen (nr 100) om lika lön för lika arbete. 
lika (adverb)	Han trivdes bra i drottningens sällskap, men han trivdes inte lika bra i Sverige. 
styck (noun)	Orvar Lundin (i stycket 20) är alltså född 1966. 
faktisk (adjective)	Men det finns faktiskt djur i Sverige som på olika sätt kan vara mycket farliga för människan. 
städa (verb)	Varje söndag städar jag. 
familj (noun)	Han startade ett eget företag där och efter fem år flyttade familjen efter honom. 
stänga (verb)	Jag skulle vilja stänga köpcentret utanför stan. 
lista (noun)	Vi gör en lista över deras argument. 
stå (verb)	Att det var så stod tämligen klart vid hennes död den 31 augusti 1997. 
lite (adverb)	Det talas minst 140 språk i landet i dag och det har gått snabbt. 
lite grand (pnm)	Nej, jag talar bara lite grand. 
liten (adjective)	Jag tänkte mycket på språkets betydelse när jag var liten. 
litteratur (noun)	Sedan år 1901 delar man varje år ut nobelpris i fysik, kemi, medicin och litteratur. 
liv (noun)	Sedan säger han: Nu skalar du för livet. 
stå till (vbm)	Hur står det till? 
fantastisk (adjective)	De hade en fantastisk utsikt från berget. 
stökig (adjective)	Kaffehus växte fram i städerna som en motvikt till de stökiga brännvinskrogarna. 
farbror (noun)	Då kom nästan alla, min faster och farbror, mina mostrar, farfar och farmor, mormor och en massa kusiner. 
farfar (noun)	D: Farfar och hans blommor. 
farmor (noun)	Kungens mor var också från Tyskland, och hans farmor från England. 
subtraktion (noun)	Ibland använder man de mer internationella orden addition, subtraktion, multiplikation och division. 
suddgummi (noun)	Tja ... en mobiltelefon, en karta, ett paket tuggummi, en kam, en ordbok, en penna och ett suddgummi. 
faster (noun)	Då kom nästan alla, min faster och farbror, mina mostrar, farfar och farmor, mormor och en massa kusiner. 
ljus (adjective)	Då går solen aldrig ner här och det är ljust hela natten. 
fatta (verb)	Det fattar du väl! 
favoritprogram (noun)	Klockan nio börjar Renates favoritprogram på teve. 
svara (verb)	Själv skulle han säkert ha svarat nej på frågan. 
fel (adjective)	Hon: Nej, det är fel! 
fel (noun)	Felet ska inte straffas, 
fem (numeral)	Han startade ett eget företag där och efter fem år flyttade familjen efter honom. 
femton (numeral)	Fem gånger tre är lika med femton. 
svensk (noun)	Finländare tycker också att svenskar pratar kringelikrokigt. 
svensk (adjective)	I genomsnitt ägnar svenska kvinnor 81 minuter och svenska män 64 minuter per dag åt Facebook. 
svenska (noun)	Han mötte det han hellre säger på engelska än förklarar på svenska, the spirit of place. 
fest (noun)	Teve sänder både från prisceremonin och festen efteråt, och i många länder följer man evenemanget med stort intresse. 
lunch (noun)	Varje dag klockan 12 äter jag lunch. 
festsal (noun)	Festsalen är dekorerad med blommor från San Remo. 
lust (noun)	Har du lust att bada bastu med mig? 
film (noun)	Och så får du en film på köpet! 
lycka till (inm)	LISA: Lycka till med engelskan! 
svärson (noun)	De gillar sin svärson. 
svår (adjective)	Vad är det som gör det svårt att förstå och att bli förstådd? 
filmjölk (noun)	Hon är mycket trött och äter bara lite filmjölk och ett äpple. 
swahili (noun)	Bantuspråk: swahili, ett viktigt övernationellt kommunikationsspråk i Östafrika 
filmrulle (noun)	Bosse: Jag ska lämna in filmrullarna för framkallning i morgon. 
sy (verb)	Vem tvättar, handlar mat, syr, tvättar fönster, dammsuger, lagar mat, diskar, bäddar och städar hemma? 
lyssna (verb)	Och samtalen blev privatare, nu när ingen lyssnade längre. 
fin (adjective)	I Norge är det fint att vara lantis, där talar man gärna och mycket om var man kommer ifrån. 
sydöstra (adjective)	Till sydöstra Sverige åker turister från Tyskland. 
läge (noun)	Tjena, hur är läget? 
lägenhet (noun)	Vi gifte oss och hittade en lägenhet utanför staden, och där bodde vi i fem år. 
finna (verb)	Man ska då finna, att hur mycket man än har ansträngt sig, kommer språkgranskaren ändå att ändra. 
finsk (adjective)	RITVA: Jag kommer från Finland, och jag talar finska och svenska och lite engelska. 
synd (adverb)	Synd bara att det går så fort att äta upp den. 
lägga sig (vbm)	Sofia och Klara har just gått och lagt sig. 
fisk (noun)	En sportfiskare är en människa man eller kvinna som fiskar på fritiden. 
fiska (verb)	Ibland badade vi och simmade efter kanoten, och ibland fiskade vi. 
läkare (noun)	Alla måste välja, välja bland olika elbolag, telebolag, läkare, försäkringar och sparandeformer. 
syskon (noun)	Hennes värld var böckernas värld och hon kunde koncentrera sig fastän syskonen lekte runt omkring henne. 
fixa (verb)	Eva, Elin och Malin har fixat annan mat. 
längd (noun)	Det är viktigt att stavarna är lagom långa och passar till din längd. 
syster (noun)	Farman Sediq vaktade sina systrars oskuld och ansåg att de flickor han själv hade sex med var horor. 
länge (adverb)	Och samtalen blev privatare, nu när ingen lyssnade längre. 
säga (verb)	Det sägs exempelvis att hon för det mesta gick omkring i herrskor. 
säga sig (vbm)	Jag är både lycklig och stolt, sa han till sig själv. 
längta (verb)	Sara var trött på vuxenrelationer men hon längtade enormt mycket efter barn. 
flaska (noun)	Vi kan sitta och prata hela nätterna över en flaska vin. 
flera (prounoun)	Flera av Peter Kihlgårds romaner har kommit till under resor till fjärran länder. 
sälja (verb)	Chefen: Vi måste sälja mer! 
sällan (adverb)	Hemma i Sverige skojar vi ofta om vår svenskhet och sällan lägger vi något positivt i det. 
lärare (noun)	Läraren: Varför kom du inte till skolan igår? 
flicka (noun)	Flickor umgås helst med sina vänner på sociala sajter, t.ex. Facebook. 
flickvän (noun)	Daniel och hans flickvän, Åsa, sitter på en restaurang. 
säng (noun)	Många suckar och stiger motvilligt upp ur sängen. 
sängbord (noun)	Mellan sängen och skrivbordet har han ett litet sängbord. 
läsa (verb)	När han kom tillbaka kunde han tala hjälpligt, men framför allt kunde han skriva och läsa. 
sätt (noun)	Personligheten växlar när man byter språk, och varje aspekt är autentisk på sitt sätt. 
sätta (verb)	Han åkte ner till mitt hemland och satte sig på skolbänken. 
sätta sig (vbm)	Vi sätter i oss massor av godis och billig skräpmat vilket leder till sjukdomar. 
sätta upp (vbm)	Tjejerna bäddar i båten, och killarna sätter upp * tältet och tänder grillen. 
så (conjunction)	Så det är kanske mig alla insändare handlar om? 
så (adverb)	Jag skakar på huvudet och låter så förnärmad jag kan. 
så där (jjm)	Tja, spelar basket, går ut och dansar och så där ... 
så här (abm)	Så här gör man. 
flyta (verb)	Den flyter förbi i Atlanten utanför Skandinavien, och den är varm. 
flytta (verb)	Han startade ett eget företag där och efter fem år flyttade familjen efter honom. 
sån (prounoun)	Men sånt hör man. 
låna (verb)	Mikael har fått låna Malenas stora träskor, mormors långa kjol, mammas gula sjal och farmors gamla kaffepanna. 
lång (adjective)	Så önska dig att lång blir denna resa. 
söder (noun)	söder och 40 mil från väster 
folk (noun)	Och retar oss på att folk pratar i mobilen vid fel tillfällen. 
södra (adjective)	Den största staden heter Karlstad och den ligger i södra Värmland vid sjön Vänern. 
söndag (noun)	Varje söndag städar jag. 
fond (noun)	Självklart sparar jag i aktier och fonder också men boendet är den största investeringen. 
lön (noun)	EMIL: Jag fick ingen lön. 
sönder (pl)	Jo, Bos bil var sönder och han hade glömt att laga den. 
söt (adjective)	Å: Så söta de är! 
ta (verb)	Värre är det att man ibland inte kan ta deras nej på allvar. 
lördag (noun)	Lördag stundar helgen till. 
lördagsmorgon (noun)	Jonas och Daniel stiger upp tidigt på lördagsmorgonen. 
lösa (verb)	Löser ni in rese-checkar? 
forska (verb)	Juris: Jag forskar i svensk historia. 
forskare (noun)	Forskarna kallar språket urgermanska. 
ta hem (vbm)	Jag hade bestämt mig för att ta hem ett olympiskt guld en dag. 
forskning (noun)	Marie och Pierre brann för sin forskning och tillbringade mycket tid i sina laboratorier. 
ta kväll (vbm)	Ska vi ta en öl i kväll när vi har handlat? 
ta med (vbm)	Jag tar med mig min bok och sätter på min kassettbandspelare. 
maffia (noun)	Ett tyskt program om öl eller ett italienskt program om maffian? 
fort (adverb)	Så fort vi reser någonstans har hon massor av vykort att skriva. 
fortfarande (adverb)	När Jack Butler fortfarande levde spelade Peter Austin in deras samtal. 
fortsätta (verb)	En möjlighet att fortsätta i annan form fanns förstås, inom Stockholm till exempel gick fem postturer om dagen. 
ta tid (vbm)	Därför tar det lång tid ca 30 år för vattnet i Östersjön att bytas ut. 
fotboll (noun)	Klara är också hemma men hon tittar inte på fotboll. 
fotbollsmatch (noun)	Först fotbollsmatch på Ullevi, sedan träffa gamla kompisar på en pub på Avenyn. 
ta ut (vbm)	Cirka 40 procent av dem tas ut till en tjänstgöring på mellan tre och arton månader. 
mamma (noun)	En mamma är inte där 
foto (noun)	Och du som inte kan Å: När tog du det fotot? 
man (prounoun)	I Indien lägger man tonvikt på första stavelsen i event. 
fotoalbum (noun)	D Daniel och Åsa har en skön hemmakväll och sitter och tittar i Daniels fotoalbum efter middagen. 
man (noun)	I genomsnitt ägnar svenska kvinnor 81 minuter och svenska män 64 minuter per dag åt Facebook. 
tack (interjection)	När säger man tack shelv? ' 
tack (noun)	Hur man säger tack? 
fotograf (noun)	A: Du är en bra fotograf! 
fotografera (verb)	D: Jag fotograferade ju diplomen. 
fram (adverb)	Fram till sin död 1689 levde Kristina i Palazzo Corsini i Rom. 
tak (noun)	Taklampan hänger han i taket och affischerna sätter han upp på väggen. 
framför (preposition)	När han kom tillbaka kunde han tala hjälpligt, men framför allt kunde han skriva och läsa. 
taklampa (noun)	I taket hänger en vit taklampa. 
tala (verb)	Det talas minst 140 språk i landet i dag och det har gått snabbt. 
tala om (vbm)	Säg: Jag talar inte engelska, även om du gör det. 
fransk (adjective)	Han gillar fransk mat och italienska kläder. 
franska (noun)	Innan hon fyllde tolv år kunde hon konversera på grekiska, latin, franska och tyska. 
tand (noun)	Varje morgon vaknar jag, bäddar sängen duschar och borstar tänderna. 
fransman (noun)	Daniels syster Anna är gift med Pierre som är fransman. 
tandläkare (noun)	Sara: Ja, jag är tandläkare. 
fraslista (noun)	Träna vidare i fraslistan! 
fredag (noun)	Fredag gör jag vad jag vill. 
massa (noun)	Vi sätter i oss massor av godis och billig skräpmat vilket leder till sjukdomar. 
tank (noun)	Tanken på att få hem kronofogden är en fasa för många. 
mat (noun)	Kanske var det ont om mat. 
tant (noun)	D: Tant Elsa och hennes hundar. 
match (noun)	Jonas: Du, vi måste handla till helgen, men det kan vi göra efter matchen för 
fri (adjective)	vill ha ett fritt näringsliv, men också sociala reformer. 
taxi (noun)	Bosse Palmgren är 48 år och kör taxi. 
taxichaufför (noun)	vi har en granne som är taxichaufför. 
te (noun)	Då dricker vi te eller kaffe, 
teater (noun)	B Nej, jag lyssnar på radio och läser och går på teater och bio ... 
frimärke (noun)	(Man kan också köpa frimärken i affärer och kiosker.) 
matta (noun)	Bosse behöver en matta, ett skåp och några lampor. 
frisör (noun)	Klockan fyra går han till frisören. 
fritid (noun)	På fritiden ägnar hon sig helst åt shopping och hon går också gärna på konstutställningar. 
med (pl)	En smula äventyrslusta finns alltid med och äventyrslustens drivkrafter är inte obekanta. 
med (preposition)	Man har sagt att hon log med stängd mun för att hon hade dåliga tänder. 
telefon (noun)	I början av 1990-talet kom de första mobila telefonerna som var tunga bananliknande jättetelefoner. 
fru (noun)	1935 träffade jag min fru Greta. 
frukost (noun)	Hon vaknar klockan sju, och halv åtta stiger hon upp och lagar frukost. 
medan (sn)	Medan franskan snarast är fräsig och boklig. 
telefonkort (noun)	— Nej, kan jag få ett telefonkort också, tack. 
medborgare (noun)	Alla som bor i Sverige, svenskar och ca 500 000 utländska medborgare, har ett personnummer: 
telefonnummer (noun)	Vad har du för telefonnummer? 
fråga (verb)	Ett par minuter senare avslutar hon samtalet och frågar vad dottern ville. 
medicin (noun)	Redan vid 20 års ålder var han känd för sina kunskaper i medicin, astronomi, matematik och filosofi. 
från (preposition)	ord som lånats in från andra språk. 
från början (abm)	Men jag är journalist från början. 
tennismatch (noun)	Ska vi gå på tennismatchen på söndag? 
mejl (noun)	På eftermiddagen skriver Renate ett mejl till en vän i USA. 
mellan (preposition)	De allra flesta är mellan 16 och 29 år, därefter klingar andelen sensationssökare av. 
teve (noun)	(Va, har du inte någon teve?) 
teveprogram (noun)	Ett engelskt teveprogram om psykologi? 
melodi (noun)	Om du inte förstår: lyssna på språkets rytm och melodi. 
fy (interjection)	Nej, fy vad tråkigt! 
men (conjunction)	Men han var inte bara uppfinnare och affärsman. 
fylla år (vbm)	Jag fyller ju inte jämna år. 
mena (verb)	Vad menar du med att du inte har någon bror? 
fyra (numeral)	Jiwarli har fyra former för att skilja mellan en, två, några stycken (som går att räkna) och många (oräkneliga). 
mer (adverb)	Det finns mer än dubbelt så många Johansson. 
fysik (noun)	Sedan år 1901 delar man varje år ut nobelpris i fysik, kemi, medicin och litteratur. 
thailändsk (adjective)	Sukanya: Jag har en thailändsk restaurang med min man. 
tid (noun)	Det var på den tiden då de två viktigaste skolböckerna var Bibeln och skolatlasen. 
tidig (adjective)	Siffrorna 7-8 visade tidigare födelseort, men väljs nu slumpmässigt. 
tidning (noun)	Elna: Jaså, är vi så märkvärdiga att vi ska bli intervjuade i tidningen? 
meter (noun)	hon var snabbast på 60 meter jag var långsammast 
middag (noun)	Jag älskar att sova middag. 
till (preposition)	Han åkte ner till mitt hemland och satte sig på skolbänken. 
till (pl)	Ibland är det dessutom praktiskt att ha ett hemligt språk att ta till, fnittrar de: 
färsk (adjective)	Många turister kommer till Smögen för att köpa färska räkor. 
till exempel (abm)	En möjlighet att fortsätta i annan form fanns förstås, inom Stockholm till exempel gick fem postturer om dagen. 
få (verb)	I en katalog fick de sig presenterat ett stort urval av villiga donatorer. 
till höger (abm)	Till höger ser vi också kungen, men här är han bara ett par månader gammal. 
mil (noun)	Från Smygehuk till Rom, Italiens huvudstad, är det också 160 mil. 
miljon (noun)	Förra året registrerades 703 miljoner internationella ankomster. 
till sängs (abm)	Lasse och Mona går till sängs. 
till vänster (abm)	Och sväng till vänster där framme! 
tillbaka (adverb)	Här är kvittot och tjugonio kronor tillbaka. 
fåtölj (noun)	Det finns en gammal soffa, två fåtöljer, en tv och ett bord i vardagsrummet. 
föda (verb)	ett barn som föds långt senare än sitt/sina syskon. 
födelsedatum (noun)	Siffra 5 och 6 är födelsedatum. 
födelseort (noun)	Siffrorna 7-8 visade tidigare födelseort, men väljs nu slumpmässigt. 
födelseår (noun)	Siffra 1 och 2 betyder födelseår. 
följa (verb)	Att Uppsalabor inte följer högerregeln. 
fönster (noun)	Hon tittar ut genom fönstret. 
för (preposition)	Det sägs exempelvis att hon för det mesta gick omkring i herrskor. 
tillsammans (adverb)	Redan som små barn tillägnar vi oss ett visst beteende tillsammans med språket. 
för (conjunction)	Han måste w ha tittat en stund för nu vinkar han. 
minus (noun)	Sju minus fem är lika med två. 
för sent (abm)	Med andra ord: I Sverige har alla möjlighet att studera och det är aldrig för sent att börja! 
tillåta (verb)	När vädret tillåter har vi promenader längs ån. 
timme (noun)	Efter högst tre timmar får du bekräftelse på att din bokning klickat. 
tio (numeral)	Efter bara tio månader som socialassistent hoppade hon av. 
tisdag (noun)	varje måndag, tisdag och torsdag. 
titta (verb)	Han tittar på mig. 
tja (interjection)	Tja, spelar basket, går ut och dansar och så där ... 
tjej (noun)	Han håller föredrag i skolor och på arbetsplatser och leder kurser för både killar och tjejer. 
mitt (adverb)	Jan Garnert är etnolog och mitt uppe i ett forskningsprojekt om hur telefonen har påverkat våra liv. 
tjena (interjection)	Tjena, hur är läget? 
mittemot (preposition)	Där på vänster sida ligger den, mittemot stationen. 
före (preposition)	Före övergången flödade information och goda råd från radio och TV. 
tjugo (numeral)	Regeringen består av ungefär tjugo ministrar och chefen för regeringen kallas statsminister. 
tjugonio (numeral)	Här är kvittot och tjugonio kronor tillbaka. 
tjugotre (numeral)	EXPEDITEN: Dom kostar tjugotre kronor styck. 
tjuvlyssna (verb)	Tjuvlyssna på folk på gatan, på bussen, på tåget osv. 
tjäll (noun)	Nästa dag tar Daniel och Jonas tåget till Abisko eftersom de ska vandra i tjällen i en vecka. 
mobiltelefon (noun)	Vad kostar den där mobiltelefonen? 
tjäna (verb)	Men jag tjänade ganska mycket, 4 500 i juni och 8 000 i juli. 
föreställning (noun)	Så ofta jag kan åker jag med min väninna och ser de riktigt stora föreställningarna. 
företag (noun)	Företagen vill inte bara bli så internationellt stora som möjligt. 
toalett (noun)	Peter: Det är ett stort dubbelrum med dusch och toalett och hotellet har en fin pool. 
molnig (adjective)	Det är molnigt i Spanien. 
författare (noun)	Det var då hon blev författare. 
tolv (numeral)	Hon arbetar till tolv, och sedan har hon lunch till kvart i ett. 
morbror (noun)	Min morbror flyttade till Nya Zeeland för tio år sedan och startade en strutsfarm där. 
morfar (noun)	Morfar: Vad gör ni? 
morgon (noun)	Och de första orden på morgonen: Har du sovit gott? 
topp (noun)	Därifrån promenerade de upp till bergets topp, där de hittade ett fint ställe. 
mormor (noun)	Mormor: Till Åmål, har jag ju sagt. 
förlåta (verb)	Läraren säger till Hanna: Förlåt mig! 
förmiddag (noun)	Varje förmiddag sitter jag på kontoret och jobbar. 
moster (noun)	Då kom nästan alla, min faster och farbror, mina mostrar, farfar och farmor, mormor och en massa kusiner. 
mot (preposition)	Och han gör en gest mot pannan. 
torsdag (noun)	varje måndag, tisdag och torsdag. 
förnamn (noun)	Jag heter Sunhi i förnamn. 
trafikljus (noun)	Gå till vänster vid trafikljusen och över bron. 
förra (adjective)	Lilla Linnea föddes den 14 september förra året. 
förresten (adverb)	Ge mig din adress så skickar jag en målning till dig, sa konstnären, som förresten hette Gary. 
multiplikation (noun)	Ibland använder man de mer internationella orden addition, subtraktion, multiplikation och division. 
först (adverb)	Ska man säga något negativt måste man först säga något positivt, klagar finländarna över svenskarna. 
tre (numeral)	Efter högst tre timmar får du bekräftelse på att din bokning klickat. 
musik (noun)	Han älskar klassisk musik och jazz. 
trettio (numeral)	Det är arton grader varmt i Stockholm och det är trettio grader varmt i Madrid. 
förstå (verb)	Vad är det som gör det svårt att förstå och att bli förstådd? 
trevlig (adjective)	Inte lätt att behålla lugnet, att vara snäll och trevlig. 
trevlig helg (inm)	De är på gott humör * därför att de har haft en trevlig helg. 
förstås (adverb)	Hamburgarna är förstås större, men är de godare också? 
mycken (prounoun)	Torbjörn: Nej, det är alldeles för mycket! 
mycket (adverb)	Ålder och kön är de två faktorer som utmärker sensationssökarna mest. 
myggolja (noun)	mycket plåster och massor av myggolja! 
mynna (verb)	Den rinner från Norge genom Värmland och mynnar ut i Sveriges största sjö, Vänern. 
trivas (verb)	Och du då, trivs du med ditt jobb? 
tro (verb)	Jag tror att barnen upplever att de blir mindre viktiga än telefonsamtalet eller mejlet som jag måste skicka omedelbart. 
försöka (verb)	Men jag skulle aldrig kunna åstadkomma det jag vill om jag försökte skriva en hel roman på malungsmål. 
människa (noun)	Men det beror kanske på att den handlar om två människor som råkade bli mina föräldrar. 
mäta (verb)	Vi mäter med radar på de mest olycksdrabbade vägarna och även med kamera. 
må (verb)	När man avslutat ett uppdrag, hur mår egentligen kroppen och hur gör du för att återhämta dig? 
måla (verb)	Vem stryker, snickrar, målar och betalar räkningar? 
målare (noun)	Ellen arbetar på posten och Jonas är målare och har egen firma. 
månad (noun)	Men inte mer än 36 månader. 
måndag (noun)	varje måndag, tisdag och torsdag. 
trädgård (noun)	Det kommer att dröja innan vi kan sätta igång med vårarbetet i trädgården. 
trädgårdsmästare (noun)	Brian: De är pensionärer nu, men min pappa arbetade som trädgårdsmästare och min mamma forskade. 
förälder (noun)	Men det beror kanske på att den handlar om två människor som råkade bli mina föräldrar. 
mången (prounoun)	Sedan dess har över hälften försvunnit, och många fler är hotade. 
mången (adjective)	Samtidigt höll våra grannländer och de flesta andra europeiska länder till höger. 
träffa (verb)	Nu när vi träffas i smyg. 
måste (verb)	Jag tror att barnen upplever att de blir mindre viktiga än telefonsamtalet eller mejlet som jag måste skicka omedelbart. 
träindustri (noun)	I Värmland finns det stora träindustrier, som bland annat producerar papper och pappersmassa. 
träna (verb)	Han tänker träna två eller tre gånger i veckan. 
möjlig (adjective)	Ändå är kommunikation något möjligt. 
gammal (adjective)	Det ligger i Roms gamla stadsdel och är numera ett tavelmuseum. 
ganska (adverb)	Det har vi levt med ganska länge nu. 
mörk (adjective)	som sol över mörka gärden. 
tråkig (adjective)	De som jag känner är så tråkiga och ointressanta! 
garderob (noun)	I sovrummet fmns det tre sängar, två garderober, en väckarklocka och en liten radio. 
tröja (noun)	Du, glöm inte en varm tröja. 
trött (adjective)	Hur kan jag vara så trött fast jag har sovit i tolv timmar?! 
gata (noun)	Man måste visa hänsyn och respektera varandra för att kunna samsas på gator och vägar i staden! 
möta (verb)	Han mötte det han hellre säger på engelska än förklarar på svenska, the spirit of place. 
tuggummi (noun)	— Jag skulle vilja ha ett paket tuggummi, tack. 
namn (noun)	Om Per var byns smed blev hans namn Per Smed. 
tung (adjective)	Det var ett tungt och smutsigt arbete och jag tjänade bara 50 öre i timmen. 
nationalitet (noun)	Alla nationaliteter vill titta på Stockholm. 
tunnelbana (noun)	Du kan åka tunnelbana till T-Centralen och byta till buss 65 som går till Moderna museet. 
genom (preposition)	Det är utan tvekan min största och viktigaste resa genom livet. 
natt (noun)	Med andra ord behöver man inte sova fler timmar än normalt nästa natt för att ta igen förlorad sömn. 
turist (noun)	Endast 2,5 procent av världens turister kommer från Afrika. 
turista (verb)	Var turistar man i Sverige? 
turistbyrå (noun)	Ursäkta, men är det här vägen till turistbyrån? 
turistparadis (noun)	De äter frukost och seglar till Smögen, ett litet turistparadis. 
natur (noun)	Att vi inte bryr oss om riskerna och naturen. 
naturligtvis (adverb)	Ja, naturligtvis, absolut, säger Straat. 
tusen (numeral)	Bara jukeboxen och möblerna kostar hundra tusen kronor. 
tv (noun)	Allt som behövs för att koppla av efter ett arbetspass finns här schack, kaffe, mikrovågsugn och tv. 
gifta sig (vbm)	En invandrares enda chans att komma in i gemenskapen är att gifta in sig. 
gilla (verb)	Om du inte gillar att jogga eller springa är det här den perfekta motionen. 
gitarr (noun)	Och han spelar gitarr. 
glad (adjective)	Och när han såg dem han skänkt liv och matvara missnöjda, blev han inte glad. 
glas (noun)	Så tänder man en cigarr, häller upp ett glas champagne och skålar. 
tvätta (verb)	Han duschade och tvättade sig extra noga, rakade sig och borstade tänderna. 
tvättmedel (noun)	Hon är med i en reklamfilm om tvättmedel. 
nej (interjection)	Nej, den är lagom. 
två (numeral)	Men det beror kanske på att den handlar om två människor som råkade bli mina föräldrar. 
ner (pl)	Han åkte ner till mitt hemland och satte sig på skolbänken. 
tycka (verb)	Finländare tycker också att svenskar pratar kringelikrokigt. 
glömma (verb)	Men vi får inte glömma bort att bakom den öppna dörren kan det finnas ett halt golv. 
ni (prounoun)	Tilltalsordet ni hade länge använts men endast uppifrån och ner, dvs. 
god (adjective)	Barnen blev bättre på maori än sina föräldrar. 
typisk (adjective)	En typisk dialog vid en kiosk: 
god morgon (inm)	En vaktmästare: God morgon! 
nio (numeral)	Sedan diskar han, och klockan nio sitter han vid datorn. 
god natt (inm)	Lasse: God natt, lilla gumman! 
nitroglycerin (noun)	Där började de experimentera med nitroglycerin. 
tysk (adjective)	Håller vi på att få ett neutralt pronomen av tysk och fransk modell? 
tyska (noun)	Innan hon fyllde tolv år kunde hon konversera på grekiska, latin, franska och tyska. 
tyvärr (adverb)	Växeln: Han sitter tyvärr i sammanträde. 
nja (interjection)	Nja, det är hon inte. 
tält (noun)	D: Vi och vårt tält. 
tälta (verb)	Ibland övernattar de på vandrarhem, ibland tältar de. 
nobelmuseum (noun)	Gå till Nobelmuseet eller besök Vinterviken och se Nobels dynamitfabrik. 
nobelpris (noun)	Nobelpriset och Sverige är på allas läppar! 
tända (verb)	Så tänder man en cigarr, häller upp ett glas champagne och skålar. 
golv (noun)	Skivstången lägger han under sängen och högtalarna ställer han på golvet. 
tänka (verb)	Jag tänkte mycket på språkets betydelse när jag var liten. 
grad (noun)	Böj armen i 90 graders vinkel, håll armbågen låst och pendla med armarna medan du går. 
tåg (noun)	Urban: Men nu kommer visst mitt tåg. 
normal (adjective)	BARNMORSKAN: Det är normalt. 
granne (noun)	Grammofon får hon förstås spela, men hon måste tänka på grannarna också. 
norr (noun)	Det är 160 mil från norr till 
norra (adjective)	I norra Sverige skiner solen 24 timmar om dygnet under sommaren (ibland är det förstås mulet! 
grekisk (adjective)	Exempel på moderna latinska och grekiska lånord är telefon, elektricitet, diabetes, hygien. 
udda (adjective)	udda nummer = män 
nu (adverb)	Men nu har den amerikanska flugan surrat in även i politikernas språk. 
grill (noun)	De packar in allt i båten, inklusive Jonas gitarr och Pelles grill. 
grillkorv (noun)	Daniel, Jonas och Pelle har köpt drycker, grillkorv och bröd. 
nummer (noun)	jämna nummer = kvinnor. 
under (preposition)	Bara när det hakar upp sig eller man verkligen behöver ett handtag, ska man under ett samtal korrigera. 
ny (adjective)	Här är det nya upplevelser som lockar. 
underbar (adjective)	Efter den första seglingsdagen hade Daniel och hans vänner en underbar sommarnatt på den lilla ön i Göteborgs skärgård. 
grupparbete (noun)	Hon börjar med ett grupparbete där klockan två. 
gruva (noun)	Där finns en stor gruva där man bryter järnmalm. 
gräns (noun)	Det går inte att dra några gränser. 
ung (adjective)	Är Mona Lisa kanske en ung man som klätt ut sig till kvinna? 
ungefär (adverb)	Sammanlagt talas sydsamiska av ungefär femhundra människor i Sverige och Norge. 
när (ha)	Det fulaste är när de skyller på andra. 
universitet (noun)	Ulla-Britt Kotsinas, numera biträdande professor i nordiska språk vid Stockholms universitet, gjorde då ett forskningsarbete om ungdomars speciella gruppspråk. 
universum (noun)	Vi vet ändå att universum hela tiden utvidgar sig, som en ballong som du blåser upp. 
upp (pl)	Den ställer de flesta bilister upp på både i teorin och praktiken. 
gubbe (noun)	Mona: God morgon, min lilla gubbe! 
gul (adjective)	På fötterna, slutligen, har hon gula träskor. 
nästa (adjective)	Med andra ord behöver man inte sova fler timmar än normalt nästa natt för att ta igen förlorad sömn. 
nästan (adverb)	Det har han också nästan gjort. 
någon (prounoun)	till Någon som passar mej 
någon (dt)	Straat hör hur man ropar upp några nummer i högtalaren. 
gumma (noun)	Lasse: God natt, lilla gumman! 
nöje (noun)	Som småbarnsförälder hinner man inte med så många nöjen. 
gärna (adverb)	Han mötte det han hellre säger på engelska än förklarar på svenska, the spirit of place. 
gäst (noun)	Ibland får jag förstås gäster, men då brukar jag försöka städa undan lite grand ... 
gå (verb)	Det sägs exempelvis att hon för det mesta gick omkring i herrskor. 
gå hem (vbm)	Klockan är fem och Lasse går hem. 
och (conjunction)	Men han var inte bara uppfinnare och affärsman. 
också (adverb)	Finländare tycker också att svenskar pratar kringelikrokigt. 
gå in (vbm)	Jag vinkar tillbaka och går in. 
gå ner (vbm)	Då går solen aldrig ner här och det är ljust hela natten. 
gå upp (vbm)	Vem går upp först? 
gå ut (vbm)	Tvärtom har islänningarna drivit en språkpolitik som går ut på att skydda isländskan från internationell påverkan. 
gång (noun)	Han undrade själv många gånger. 
gård (noun)	Men han kommer med och städar gården på 
ofta (adverb)	Miraklen infinner sig, ganska ofta, och det är om dessa mirakel av språklig förståelse som jag vill tala. 
ogift (adjective)	Hon är ogift och bor också ensam. 
oh (interjection)	Oh, vad roligt för dig, Ellen. 
göra (verb)	Blombuketten överlämnades och pappas kyss på handen gjorde Stina litet generad. 
oj (interjection)	Å: Oj, vad du ser ung ut! 
okej (adjective)	Men först skulle Lotta gärna vilja ta några foton om det är okej. 
ursäkta (verb)	Hanna: Ursäkta att jag kommer för sent. 
ursäkta sig (vbm)	Ursäkta mig, var ligger apoteket? 
olik (adjective)	Under åren har jag fått vänner på olika håll i världen, och jag har internationella engagemang utanför själva jobbet. 
usch (interjection)	Daniel: Usch, och jag är redan trött. 
ha (verb)	Jag har förlorat mitt språk 
ut (pl)	Är Mona Lisa kanske en ung man som klätt ut sig till kvinna? 
ha det (inm)	Ha det så bra! 
utan (preposition)	Det är utan tvekan min största och viktigaste resa genom livet. 
utan (conjunction)	Man måste inte bara hålla reda på alla i gruppen utan även på deras relationer sinsemellan. 
utanför (preposition)	Ett barn som fötts utanför äktenskapet kallades för oäkta barn och kunde inte ärva som andra barn. 
ha rätt (vbm)	Under tjänstgöringen är kläder, mat och husrum gratis och man har rätt till en gratis hemresa per vecka. 
ha råd (vbm)	Jag reser så mycket jag har råd. 
olycka (noun)	Det har hänt en olycka här ute på gatan. 
om (sn)	Om Per var byns smed blev hans namn Per Smed. 
om (preposition)	Men det beror kanske på att den handlar om två människor som råkade bli mina föräldrar. 
hall (noun)	Först kommer man in i en smal hall. 
hallå (interjection)	Hallå !Är Anneli hemma? 
hallåman (noun)	En hallåman: God afton! 
halv (adjective)	Klockan halv fem kom Viktor hem från skolan. 
ute (pl)	Det var en bild, som föreställde en man som hade varit ute hela natten. 
ute (adverb)	Att vara ute på nätet är nu vanligare än att umgås med kompisar i verkliga livet. 
omkring (adverb)	Det sägs att hon fortfarande cyklade omkring när hon var 100 år. 
halvtimme (noun)	Nej, högst en halvtimme. 
hamburgare (noun)	Han äter en hamburgare i bilen på vägen hem. 
han (prounoun)	Men han var inte bara uppfinnare och affärsman. 
utifrån (preposition)	Men jag har radion på också och varierar ljudet på den utifrån vad som är mest intressant för tillfället. 
onsdag (noun)	Onsdag går jag ut och vankar. 
opera (noun)	Operans biljettkontor 50 50. 
handla (verb)	Men det beror kanske på att den handlar om två människor som råkade bli mina föräldrar. 
utländsk (adjective)	Alla som bor i Sverige, svenskar och ca 500 000 utländska medborgare, har ett personnummer: 
ord (noun)	ord som lånats in från andra språk. 
ordbok (noun)	Verbets infinitivform = uppslagsform i ordboken 
hav (noun)	Mycket av fosforn tillförs från de städer runt havet som saknar moderna reningsverk. 
hej (interjection)	Hej, vet ni hur man kommer till det nya köpcentret? 
hej då (inm)	Morfar: Ja, hej då, Jonas. 
hejdå (interjection)	Hejdå, Linda och hejdå, Fabian! 
hel (adjective)	För att undvika bråk och häftiga diskussioner kan svensken ibland låta bli att säga hela sanningen. 
hela tiden (abm)	Man ger järnet hela tiden och efter matchen är man helt slut i kroppen. 
helg (noun)	Lördag stundar helgen till. 
heller (adverb)	Inte heller det känns obekvämt. 
helsvensk (adjective)	Daniels flickvän Åsa, som är polis, kommer från en helsvensk familj. 
helvete (noun)	De sätterex in jävla framför substantiv och jävel, fan eller helvetet efter. 
hem (adverb)	Halv ett går de hem. 
hem (pl)	De förväntar sig att få gå husesyn när de kommer hem till dig. 
osv (adverb)	Det finns många avdelningar på ett varuhus: en parfymavdelning, en sportavdelning, en elavdelning, en skoavdelning osv. 
hemifrån (adverb)	Klockan åtta går hon hemifrån. 
hemlighet (noun)	Nej, det är en hemlighet. 
va (interjection)	Du heter Anneli va? 
hemma (pl)	Och jag ligger hemma och är sjuk! 
hemma (adverb)	Han skapade Ikea från grunden med två tomma händer hemma i Småland. 
vacker (adjective)	Jag tycker aldrig att ett annat språk är fult tvärtom det är ofta hisnande vackert. 
vad (hp)	Vad är det där för djur? 
hemmakväll (noun)	D Daniel och Åsa har en skön hemmakväll och sitter och tittar i Daniels fotoalbum efter middagen. 
vad då (abm)	Läraren: Jaså, vad då för musik? 
vad för (pnm)	Vad är det där för djur? 
vakna (verb)	När hon vaknar måste jag stiga upp med en gång och sätta på välling. 
vaktmästare (noun)	En vaktmästare: God morgon! 
heta (verb)	Och så hylla, tänk att det kan heta skohylla också, sade pappa förtjust. 
packa (verb)	De packar in allt i båten, inklusive Jonas gitarr och Pelles grill. 
packa in (vbm)	De packar in allt i båten, inklusive Jonas gitarr och Pelles grill. 
paddlingssemester (noun)	D: Å, här är några kort från vår paddlingssemester i Småland förra året. 
paket (noun)	Jag sorterade brev och vykort, hämtade paket, städade och spelade kort på rasterna. 
vampyr (noun)	En biljett till Vampyrer klockan nio, tack. 
vandra (verb)	Och stjärnorna vandra och timmarna fly, 
vandrarhem (noun)	De kommer fram till Abisko på eftermiddagen och bor på vandrarhem första natten. 
historia (noun)	Sex timmar varje förmiddag hade hon lektioner i matematik, historia, religion och filosofi. 
vanka (verb)	Onsdag går jag ut och vankar. 
hitta (verb)	Men det är svårt att hitta stöd för att en sådan ökning verkligen sker. 
hjälp (noun)	En stor hjälp är kroppsspråket. 
hjälpa (verb)	Han läste abed för henne och hjälpte henne vagga. 
pappa (noun)	Blombuketten överlämnades och pappas kyss på handen gjorde Stina litet generad. 
var (ha)	I Norge är det fint att vara lantis, där talar man gärna och mycket om var man kommer ifrån. 
papper (noun)	Vad är det för papper? 
vara (verb)	Men han var inte bara uppfinnare och affärsman. 
vara med (vbm)	Sedan dess har Sverige varit med i svängarna, Stockholm var länge den telefontätaste staden. 
pappersmassa (noun)	I Värmland finns det stora träindustrier, som bland annat producerar papper och pappersmassa. 
varandra (prounoun)	Man måste visa hänsyn och respektera varandra för att kunna samsas på gator och vägar i staden! 
hm (interjection)	Jonas Hm, man tycker ju att man själv ser bilarna. 
hmm (interjection)	Hmm, i videobutiken finns mest amerikanska actionfilmer och dåliga komedier. 
parfym (noun)	Fransmän, spanjorer och portugiser använder mest parfym i Europa. 
vardagsrum (noun)	Det finns en gammal soffa, två fåtöljer, en tv och ett bord i vardagsrummet. 
hockey (noun)	— Skulle du vilja gå på hockey med mig på onsdag? 
varför (ha)	Varför då, i så fall? 
varifrån (ha)	Varifrån är du, Sunhi? 
hon (prounoun)	Innan hon fyllde tolv år kunde hon konversera på grekiska, latin, franska och tyska. 
varm (adjective)	Det är tyst och varmt i köket. 
pass (noun)	Och du vill ha ett pass idag? 
varsågod (interjection)	Varsågod och sätt dig ner och vänta 
varuhus (noun)	Hon arbetar på ett varuhus. 
patent (noun)	Men Alfred Nobel fortsatte arbetet och 1867 tog han patent på dynamit. 
hos (preposition)	Att tendenserna är desamma hos alla mammor och till synes universella förbluffar Patricia Kuhl. 
hotell (noun)	Frukost och andra måltider äter du i den varma delen av hotellet. 
paus (noun)	Kvart i åtta har vi en paus. 
vatten (noun)	Man måste städa, byta vatten och ge fiskarna mat, och vattnet måste vara lagom varmt och lagom surt. 
vattengympa (noun)	Där kan våra besökare bada och varje vardagsmorgon klockan nio har vi vattengympa. 
peng (noun)	På dem kan man sätta en fin skylt som talar om vem som har skänkt pengarna. 
penna (noun)	Och hon plockade fram papper och pennor och delade ut bland barnen. 
huller om buller (abm)	Det ser inte ut som * andra fotoalbum, utan alla foton är huller om buller. 
pensionär (noun)	Därför har vi en restaurang här där pensionärerna kan äta god och näringsrik mat till en billig peng. 
humor (noun)	Kristina Lugn skriver om kvinnor, ofta sådana som inte riktigt passar in i samhället, med svart humor och medkänsla. 
humör (noun)	De är på gott humör * därför att de har haft en trevlig helg. 
vecka (noun)	Alltså varannan vecka hos mamma och varannan vecka hos pappa. 
hund (noun)	D: Tant Elsa och hennes hundar. 
perfekt (adjective)	Absolut, säger Daniel det är perfekt tid för lite mat också. 
hungrig (adjective)	Jag blir riktigt hungrig! 
hur (ha)	Men ger sådana turistfällor oss en sann bild av hur sydafrikaner och tanzanier lever? 
hur dags (abm)	Hur dags äter du lunch? 
vem (hp)	Han ser allvarlig ut, tänker jag och har fortfarande ingen aning om vem han är. 
person (noun)	Exempelvis kan hon nia äldre personer på ett språk, men dua dem på ett annat. 
hus (noun)	Huset kostar 2 500 kr i månaden och bilen 500. 
personnummer (noun)	Alla som bor i Sverige, svenskar och ca 500 000 utländska medborgare, har ett personnummer: 
piano (noun)	Pianot är en present från Klaus, Renates son. 
pigg (adjective)	Då är Katarina äntligen pigg! 
veta (verb)	Människor refererade till Jantelagen utan att ha läst boken eller ens veta vem Sandemose var. 
huvudstad (noun)	Riyad är Saudiarabiens huvudstad. 
vi (prounoun)	Nu när vi träffas i smyg. 
vid (adjective)	Taket ska vara vitt med svarta lampor. 
vid (preposition)	Att det var så stod tämligen klart vid hennes död den 31 augusti 1997. 
hyra (noun)	Varje månad betalar jag hyran. 
hyra (verb)	Hon hyrde en tvåa i Algutsboda i Småland. 
videobutik (noun)	Hmm, i videobutiken finns mest amerikanska actionfilmer och dåliga komedier. 
planera (verb)	Jag har egentligen alltid planerat inför Everest. 
plastikkirurgi (noun)	Två amerikanska program om plastikkirurgi. 
hälsa (noun)	Många kvinnor och män, unga och äldre, motionerar och tänker på hälsan och figuren. 
hälsa (verb)	Hälsa Lasse och trevlig fortsättning. 
plats (noun)	Timmarna i hemmet, som oftast är den plats 
vila (verb)	när du vilar dig, 
plugg (noun)	Jag vill gärna jobba med Jonas i stället för att gå i plugget. 
plugga (verb)	Morfar: Vad pluggar du? 
hända (verb)	Vet du vad som kommer att hända om du ljuger, människa? 
vilja (verb)	Det är egentligen mest en fråga om tid och om att vilja. 
hänga (verb)	Svaret kan hänga ihop med att alkohol eller stress hindrar personen att nå den nyttiga djupsömnen. 
pluralform (noun)	Använd en ordbok för att se oregelbundna pluralformer. 
plåster (noun)	mycket plåster och massor av myggolja! 
här (adverb)	Här ligger en allvarlig fara för språket. 
vin (noun)	Naturligtvis älskar han engelskt öl, men han dricker gärna ungerskt vin till maten. 
poesi (noun)	Mmmm, det är som poesi ... 
vind (noun)	Vem kan segla förutan vind? 
pojke (noun)	sade Jonas Hassen Khemiris tunisiska pappa till sin pojke. 
pojkvän (noun)	Jag måste träffa min pojkväns föräldrar. 
polis (noun)	Jag frågar polisen i gatuhörnet. 
vinna (verb)	Det skulle vi alla vinna på. 
vinter (noun)	Men på vintern går det bra! 
hålla (verb)	Samtidigt höll våra grannländer och de flesta andra europeiska länder till höger. 
polsk (adjective)	Jag talar polska, svenska och lite tyska. 
pool (noun)	Peter: Det är ett stort dubbelrum med dusch och toalett och hotellet har en fin pool. 
popgrupp (noun)	Jonas: Det är en popgrupp. 
visa (verb)	Visar bilder på barnen. 
post (noun)	Emil går till posten. 
viss (adverb)	Men visst talar vi ofta om medaljens baksida också. 
viss (adjective)	Redan som små barn tillägnar vi oss ett visst beteende tillsammans med språket. 
hög (adjective)	Andra kännetecken sensationssökarna har är att de i högre utsträckning än andra skiljer sig, eller lever ensamma. 
potatis (noun)	Det är för potatisens skull. 
vit (adjective)	Bara en av pojkarna har stjärngossemössa, men två stycken har i alla fall vita skjortor. 
prata (verb)	Finländare tycker också att svenskar pratar kringelikrokigt. 
höra (verb)	där ingen hör vad du sjunger 
present (noun)	Det var en bra present. 
hörn (noun)	I hörnet till höger om fönstren står en liten TV. 
vykort (noun)	Han svarar på ett vykort. 
pressbyrå (noun)	Ursäkta, men hur kommer man till Pressbyrån? 
väckarklocka (noun)	I sovrummet fmns det tre sängar, två garderober, en väckarklocka och en liten radio. 
väder (noun)	Jonas: Vad är det för väder i Sverige nu? 
prick (noun)	Den där randiga fisken uppe till vänster är grön med gula ränder och prickar. 
väderprognos (noun)	På kvällen lyssnar de på väderprognosen och studerar kartan över Kungsleden. 
i (preposition)	I Indien lägger man tonvikt på första stavelsen i event. 
väg (noun)	Den miljö vi växer upp i, människor vi möter under vägen, och slumpen. 
vägg (noun)	Hans ansikte pryder väggar, och utställningsmontrar. 
i alla fall (abm)	Man kanske skulle slå ett slag för tvättstugan i alla fall. 
pris (noun)	Vårt låga pris medger ingen servering ombord. 
väl (adverb)	Führern har väl inte hunnit så långt än, tröstar Straat. 
procent (noun)	Endast 2,5 procent av världens turister kommer från Afrika. 
producera (verb)	I Värmland finns det stora träindustrier, som bland annat producerar papper och pappersmassa. 
promenad (noun)	Klockan tolv tar han en promenad. 
program (noun)	Från 2000 finns det 17 olika nationella program, samtliga är treåriga. 
promenera (verb)	Jag promenerar eller sysslar med mina frimärken. 
programmerare (noun)	Brian: Ja, jag är programmerare. 
välja (verb)	För att göra intervjuer och inspelningar valde hon Rinkeby, en förort till Stockholm. 
välkommen (adjective)	Det är finska och betyder välkommen! 
välkommen (interjection)	RECEPTIONISTEN: Välkommen på måndag då. 
psykologi (noun)	Ett engelskt teveprogram om psykologi? 
vän (noun)	Flickor umgås helst med sina vänner på sociala sajter, t.ex. Facebook. 
pub (noun)	Först fotbollsmatch på Ullevi, sedan träffa gamla kompisar på en pub på Avenyn. 
väninna (noun)	Hon duschar, ringer till en väninna och byter om. 
pussa (verb)	De pussas och kramas innan de skiljs åt *. 
vänster (adjective)	Där på vänster sida ligger den, mittemot stationen. 
på (preposition)	I Indien lägger man tonvikt på första stavelsen i event. 
på (pl)	Håller vi på att få ett neutralt pronomen av tysk och fransk modell? 
vänta (verb)	Det blir som ett segt dataspel man orkar inte vänta! 
vänta sig (vbm)	Vi väntar inte på er, om ni kommer 
r (noun)	T R Z M I E L. 
rabatt (noun)	Han har redan dragit av rabatten. 
radio (noun)	I sovrummet fmns det tre sängar, två garderober, en väckarklocka och en liten radio. 
rak (adjective)	Ett sätt att minska flygets miljöpåverkan är att hitta rakare flygvägar. 
väska (noun)	Vad kostar den där väskan då? 
rast (noun)	Vi var ute på rasten och då kom ett helt gäng tuffa killar in på skolgården. 
väster (noun)	söder och 40 mil från väster 
realisation (noun)	STINA: Rea betyder realisation. 
rea (noun)	Jag brukar alltid köpa mina sommarkläder på rea. 
västra (adjective)	Värmland ligger i västra Sverige vid gränsen till Norge. 
redan (adverb)	Redan som små barn tillägnar vi oss ett visst beteende tillsammans med språket. 
växa upp (vbm)	Den miljö vi växer upp i, människor vi möter under vägen, och slumpen. 
växla (verb)	Växla från tvåan till fyran eller från trean till femman. 
regna (verb)	Det regnar i Tyskland och i Frankrike. 
reklamfilm (noun)	Hon är med i en reklamfilm om tvättmedel. 
rekommendera (verb)	Kan ni rekommendera något? 
resa (verb)	Den självklara rätten att resa fritt gäller bara oss. 
resa (noun)	Det är utan tvekan min största och viktigaste resa genom livet. 
resebyrå (noun)	Malin är på en resebyrå och talar med Peter som säljer resor där. 
reskompis (noun)	D: Vi och våra reskompisar. 
restaurang (noun)	Han tänker göra om inredningen i restaurangen. 
yta (noun)	Sveriges yta är 450 000 km 2. 
yrke (noun)	Det kan vara yrken som flygplatsbrandman, linjereparatör eller räddningsman. 
z (noun)	Mycket tyder på att det går lika bra att säga d eller z, vilket många redan gör. 
ägg (noun)	Från hönsen får vi ägg, från fåren ull och kött, från svinen fläsk och från korna kött och mjölk. 
zoo (noun)	D: När vi var på zoo. 
äh (interjection)	Äh, det betyder ingenting, svarade Emil. 
älskling (noun)	Mona: God natt, älskling, och sov gott! 
älv (noun)	Där finns också en stor älv, som heter Klarälven. 
älska (verb)	Älskar jag tillräckligt och älskar min partner tillräckligt? 
äntligen (adverb)	Då är Katarina äntligen pigg! 
än (adverb)	Än en gång riskerar han att avslöjas. 
äpple (noun)	Hon är mycket trött och äter bara lite filmjölk och ett äpple. 
äsch (interjection)	Åsa: Äsch, var inte sentimental nu. 
äta (verb)	Ät det här hållet. 
å (interjection)	Å: Han är lik sin bror. 
även om (snm)	Även om man behärskar flera språk så har de inte samma betydelse. 
åh (interjection)	Åh förlåt, en gång till. 
åka (verb)	Åka kollektivt och cykla. 
år (noun)	Innan hon fyllde tolv år kunde hon konversera på grekiska, latin, franska och tyska. 
åt (preposition)	I genomsnitt ägnar svenska kvinnor 81 minuter och svenska män 64 minuter per dag åt Facebook. 
åter (adverb)	och aldrig jag lämnar det åter. 
åttio (numeral)	En och ... åttio, tror jag. 
ö (noun)	Det är en ö, och den heter Gotland. 
åtta (numeral)	Kvart i åtta har vi en paus. 
ögonblick (noun)	Jag funderar ett ögonblick och bestämmer mig för att det bara finns en sak att säga. 
öppna (verb)	De verkar sova lätt och öppnar ett öga då och då för att kolla vad som händer. 
öppna dörren (vbm)	Emil öppnar dörren och de går in. 
öppen (adjective)	Den är öppen från klockan nio på morgonen till klockan sex på kvällen. 
öster (noun)	Man kan säga att Sverige sträckte sig från öster till väster. 
över (preposition)	Han ensam bestämmer över ord och regler. 
över (pl)	Men kanske mest märkbar är den språkliga domänförlusten inom det naturvetenskapliga området, där engelskan så gott som tagit över. 
