i andra hand (abm)	Om man inte har ett eget hyreskontrakt kan man hyra en lägenhet i andra hand. 
absolut (adverb)	Nej, och inte duktigast heller, och absolut inte intelligentast, för det är jag! 
rik (adjective)	och är varken glad eller rik 
riksdag (noun)	1988 röstades partiet in i riksdagen, 1991 åkte det ur för att sedan komma tillbaka 1994. 
riksdagsledamot (noun)	Senast 15 juni stänger man riksdagen och riksdagsledamöterna tar ett långt sommarlov ... 
riksdagsman (noun)	Av riksdagens 349 riksdagsmän var 153 kvinnor (1999/00). 
riksdagsparti (noun)	Kristdemokraterna (kd) har sedan valet 1991 varit ett riksdagsparti. 
riksdagsval (noun)	Förutom riksdagsval kan man ha folkomröstningar i Sverige: 
adjektiv (noun)	Några pojkar i klassen kunde inte förstå skillnaden mellan substantiv, adjektiv och verb. 
i form (jjm)	Även förvåning kan ibland uttryckas i form av en svordom, t ex Det var som fan! 
adjö (interjection)	Vi måste säga adjö till våra stora, starka och törstiga bilar. 
i framtiden (abm)	Kanske doktorerar jag i framtiden. 
i fred (abm)	Gå härifrån och lämna mig i fred! 
i förrgår (abm)	I förrgår åkte hon till universitetet och sedan var hon jättetrött. 
ring (noun)	Efter några dagar lämnade Eva tillbaka ringen. 
adventsljusstake (noun)	Tänder adventsljusstaken i december. 
ringa (adjective)	I praktiken hindrar denna typ av fel i ganska ringa grad förståelsen. 
advokatbyrå (noun)	Nu är jag färdig jurist och jobbar på en advokatbyrå. 
affisch (noun)	Taklampan hänger han i taket och affischerna sätter han upp på väggen. 
ris (noun)	Ali tänker servera typisk tunisisk mat: mycket fårkött, ris, bönor och grönsaker. 
affärsidé (noun)	Han hade en ny affärsidé. 
risk (noun)	Det behöver dock inte vara själva risken som lockar, utan upplevelsen. 
i höstas (abm)	Urban: Förresten ... jag var i Rom i höstas och träffade Tommy. 
affärsman (noun)	Ett par kinesiska affärsmän väntade på henne, så hon måste ta en taxi. 
i livet (jjm)	Vi gör alla små och stora val i livet. 
rivstart (noun)	När du kommer till slutet av Rivstart kan du börja använda en enspråkig ordbok. 
i lördags (abm)	I lördags sålde man en tavla för 1,5 miljoner på auktionshuset i Uppsala. 
ro (noun)	jag sett skördarna gro på min torva i ro, 
roa sig (vbm)	Vasamuseet, Skansen och roar sig på Gröna Lund eller promenerar på de smala gatorna i Gamla Stan. 
robot (noun)	I framtiden kommer robotar att göra allt tråkigt arbete. 
i morse (abm)	I morse såg jag en kille på gatan. 
rockgrupp (noun)	Specialitet: chiliöl och chilitequila Vår mexikanska rockgrupp spelarl 
i måndags (abm)	Köparen var mycket nöjd, men i måndags meddelade en expert på Nationalmuseet att tavlan inte är av Zorn. 
i natt (abm)	I natt jag drömde något som 
roll (noun)	I det ögonblicket spelar det ingen roll. 
i ordning (jjm)	Syster, gör i ordning en bedövningsspruta. 
aktuell (adjective)	Den frågan är fortfarande mycket aktuell. 
romantisk (adjective)	Det var så vackert och romantiskt. 
i schack (abm)	Erik är på gott humör, för Daniel låter honom nästan alltid vinna i schack. 
romsås (noun)	Mona: En stekt lax med ris och romsås tack. 
i sin (jjm)	Alfreds farfars farfar bytte till namnet Nobelius och Alfreds far bytte i sin tur till Nobel. 
rop (noun)	När ropet: pappa kommer! 
alg (noun)	Algen är släkt med kon. 
alkohol (noun)	Det är regeringen som bestämmer priset på alkohol. 
rosmarin (noun)	— Jag ska äta lamm med vitlök och rosmarin. 
i stort sett (abm)	Utan att skryta måste jag säga att jag köper i stort sett allt jag vill. 
alldeles (adverb)	Släktingar har en alldeles särskild plats i vänkretsen, säger Dunbar. 
i stället för (ppm)	Det kanske lönar sig att stanna och ta sig en funderare i stället för att försöka läsa kartan springande. 
i så fall (abm)	Det skulle i så fall vara ärtsoppa och pannkakor 
allmän (adjective)	Vi fick obligatorisk allmän tilläggspension = ATP. 
i söndags (abm)	I söndags följde hon inte med på bio, utan hon var hemma hela dagen. 
i taget (abm)	Han masserade en fot i taget och klämde och tryckte. 
rubrik (noun)	I hennes arbete ingår att välja bilder, skriva bildtexter, sätta rubriker och planera tidningens sidor. 
i tid (abm)	måste du komma i tid. 
rulla (verb)	Nästa morgon vaknar hon klockan åtta, och efter en halvtimme rullar tåget in på Kiruna järnvägsstation. 
alls (adverb)	Ibland är man trött, och ibland fungerar ingenting alls. 
allting (prounoun)	Han parkerar bilen utanför porten och bär tillsammans med en kamrat upp allting och ställer det i korridoren. 
i övermorgon (abm)	H: I övermorgon då? 
allvarlig (adjective)	Du ser så allvarlig ut. 
runt (pl)	Vi går in, tar en korg och går runt och tittar på alla varor och priser. 
runt (preposition)	Träffar familjen, går en promenad runt Djurgården (Stockholm) och äter svensk mat. 
runt omkring (ppm)	Runt omkring står träden svarta och tigande. 
alternativ (noun)	Om man vill bo i lägenhet, finns det olika alternativ. 
ambassad (noun)	Han arbetar på ambassaden i London. 
rutig (adjective)	Kvinnan till höger har en rutig sjal på huvudet. 
identitet (noun)	En människa har flera identiteter, de är motsägelsefulla och ständigt i rörelse. 
ideologi (noun)	Miljöpartiet De Gröna (mp) har en decentralistisk ideologi, där samspelet mellan människa och natur är viktigt. 
rycka in (vbm)	I augusti 1707 ryckte den svenske kungen, den 27-årige Karl XII, in i Ryssland. 
rygg (noun)	Nästa morgon hade vi mycket ont i ryggen och axlarna, men vi åkte vidare ändå. 
idrottsförening (noun)	Ar 1796 startade Sveriges första idrottsförening, Uppsala simsällskap. 
idrottslärare (noun)	Han har jobbat som idrottslärare i skolan i många år. 
rymdforskningsstation (noun)	Hans flickvän, Lena, är astronom på Esrange, rymdforskningsstationen. 
andas in (vbm)	Andas in ... och ut ... En gång till. 
andas ut (vbm)	Andas in ... och ut ... En gång till. 
idé (noun)	Fast att helt avstå från nötkött är ingen bra idé, tycker de två forskarna. 
ifrån (preposition)	Älgkalven väger cirka 10 kg när den föds och efter en vecka orkar den springa ifrån en människa. 
andrahandskontrakt (noun)	Torbjörn: Nej, jag vill inte ha något andrahandskontrakt. 
igloo (noun)	Några besökare sov över i igloon och de tyckte att det var fantastiskt. 
räcka (verb)	Och när de pengarna inte räckte lånade hon en halv miljon till. 
igår (adverb)	Hon såg dig utanför Grand igår kväll. 
ihjäl (pl)	Arbeta inte ihjäl dig! 
rädd (adjective)	Därför var sjömännen rädda för en så lång resa. 
ihop (pl)	Plockar ihop sina saker och blänger på mig. 
räddningsman (noun)	Det kan vara yrken som flygplatsbrandman, linjereparatör eller räddningsman. 
ikväll (adverb)	Kunden: Nej, jag ska ha lite räkor till ikväll. 
illa (adverb)	Värst utsatta är förstås de som ligger vid ån. 
räkna (verb)	förvirrad av att räkna havets böljor. 
imitera (verb)	Imitera folk tyst för dig själv. 
ränta (noun)	I går meddelade Riksbanken att man höjer räntan med 1 procent. 
imorse (adverb)	Men jag pratade med Mia imorse. 
ankomst (noun)	Den 30 april firar nian vårens ankomst. 
rätt (adjective)	De har alltid kartan uppe, de har den alltid åt rätt håll och de pekar ofta med hela handen. 
rätt (noun)	Men kanske var det rätt ty utan mig 
rätt (adverb)	En ö rätt smutsig, 
importera (verb)	Därför importerar vi t.ex. tomater från Holland, gurka från Spanien och apelsiner från Israel. 
in (adverb)	Så ledigt jag bara kan går jag tillbaka in i chatten och svarar syster: 
rättighet (noun)	Det handlar också om mänskliga rättigheter, solidaritet mellan kvinnor och män och mellan olika folkgrupper och länder. 
inbjudan (noun)	HANNA: Jaha, tack för inbjudan, men varför bjuder du mig? 
annars (adverb)	Man måste kunna se sig själv på toppen, annars kommer man aldrig upp. 
rå (verb)	Pendeltåget går 10.22 f rår, Centralen mot Nynäshamn. 
annons (noun)	Jag läste i många olika annonser till exempel under bilförsäljare. 
rådjur (noun)	Jag älskar att jaga och äter nästan bara älg och rådjur. 
annorlunda (adjective)	Andra kommer för att köra hundspann eller lära sig något annorlunda hantverk, som att bygga fioler. 
råg (noun)	Bönderna odlar t.ex. vete, råg, raps och potatis, och många äger skog också. 
indisk (adjective)	Man kan säga att det uppstod indiska, romanska, slaviska och germanska dialekter av urspråket. 
industri (noun)	En del av järnet använder man inom svensk industri, men en stor del går på export. 
röd (adjective)	Golvet är schackrutigt, bord och stolar har blänkande krom och röda dynor. 
rödkål (noun)	Har jultomte, julklappar och äter skinka, rödkål 
industriland (noun)	Bland OECD-länderna (de flesta industriländer i världen) låg Sverige på fjärde plats 2004 när det gäller utbildningsnivå bland befolkningen. 
rödvin (noun)	Patrik: Ja, en flaska rödvin tack. 
ansluta (verb)	Nya vänner ansluter, och ju fler desto roligare, eller hur? 
infinitiv (noun)	Att före infinitiv uttalar vi ofta å. 
information (noun)	Ulrika sitter i informationen på ett stort varuhus i Stockholm. 
ansöka (verb)	Kvinnor får också ansöka om militär eller civil utbildning. 
ansökan (noun)	Om du fyller i en ansökan om bankomatkort, ska jag ordna det åt dig. 
röst (noun)	Jag slog numret och hörde en killes röst. 
rösta (verb)	Alla svenskar som är över 18 år får rösta. 
inför (preposition)	Jag har egentligen alltid planerat inför Everest. 
rösträtt (noun)	fick vi allmän rösträtt i Sverige, dvs. 
s (noun)	S: Ja, där har jag också lite tid. 
anteckningsbok (noun)	Ha alltid med dig en liten anteckningsbok. 
s k (adverb)	De har länge varit mest kvinnor, s k lapplisor. 
ingenjör (noun)	Nu är jag färdig ingenjör och jobbar på ett stort företag här i stan. 
saffran (noun)	Ett paket cigaretter, en skraplott och ett paket saffran också, tack. 
ingrediens (noun)	Man kan undra varför man gjorde en rätt med så många exotiska ingredienser på Gotland. 
saga (noun)	Gösta Berlings saga är skriven på en fantasifull och lyrisk prosa. 
apparat (noun)	Han är mycket praktisk och kan reparera bilar och fixa elektroniska apparater. 
sakna (verb)	och saknar ord för sin sorg 
inkomst (noun)	Av sin inkomst sparar Erik 0,1 procent på banken. 
sakta (adverb)	Håller vi sakta på att konsumera oss till döds? 
april (noun)	april juni och september, 
sakta men säkert (abm)	Varje vår smälter Ishotellet sakta men säkert ner i Torne älv. 
aprilhäxa (noun)	Svar: Aprilhäxan av Majgull Axelsson. 
inköpschef (noun)	Anders, ring till inköpschefen på Svenska Prylbolaget och prata med henne! 
ar (noun)	Ar 1960 var Maj-Britt Söderberg också 30 år. 
salt (noun)	1 1/2 tesked salt 
arbetarbarn (noun)	Många av lärarna tyckte inte om arbetarbarn, och jag var blyg och rädd och slutade efter tre år. 
arbetare (noun)	Arbetarna började organisera sig i fackföreningar och Socialdemokratiska arbetarepartiet grundades år 1889. 
arbetareparti (noun)	Socialdemokraterna (Sveriges socialdemokratiska arbetareparti) (s) vill verka för social och ekonomisk jämlikhet. 
saluhall (noun)	* En saluhall i Göteborg. 
samba (noun)	Efter sex månader som sambor gifte de sig, för Sofia väntade barn *. 
arbetsam (adjective)	Jag är intelligent och arbetsam. 
arbetsdag (noun)	Dorota och hennes pojkvän har långa arbetsdagar. 
inne (adverb)	Inne i lägenheten böljar de sjunga, först lite falskt men sedan låter det riktigt vackert: 
samhälle (noun)	Den kändes som en stor lättnad och spred sig snabbt i samhällets alla skikt. 
innebära (verb)	Hon hade begått ett s.k. horsbrott, vilket innebar att hon måste bekänna sina synder under gudstjänsten i kyrkan. 
innehåll (noun)	Dina ögon ser texten och din hjärna tolkar innehållet och du tänker: Vilken konstig text! 
arbetslöshet (noun)	Enligt siffror från AMS sjunker arbetslösheten. 
samisk (adjective)	De talar samiska också. 
innesko (noun)	Ta gärna med inneskor. 
samla (verb)	Jag samlade inte frimärken mer 
arbetsplats (noun)	Du har problem på din arbetsplats, ser jag. 
inomhus (adverb)	Temperaturen inomhus är mellan fem och åtta minusgrader. 
arbetstillstånd (noun)	Inom Norden behöver en svensk inte pass eller till exempel arbetstillstånd. 
inredning (noun)	Han tänker göra om inredningen i restaurangen. 
inriktning (noun)	Hennes inriktning var engelska och franska. 
sammanhang (noun)	Men det är ju väldigt ofta i negativa sammanhang som vi hör talas om växthuseffekten. 
sammanträde (noun)	Växeln: Han sitter tyvärr i sammanträde. 
samspel (noun)	Miljöpartiet De Gröna (mp) har en decentralistisk ideologi, där samspelet mellan människa och natur är viktigt. 
inspelning (noun)	I morgon är det inspelning för tv. 
samt (conjunction)	Där finns 1100 bostäder samt kontor, hotell och världens högst belägna swimmingpool som ligger på våning 76. 
arm (noun)	Med stavarna använder du också musklerna i armar, axlar och rygg. 
armbandsur (noun)	Han har ett schweiziskt armbandsur. 
institut (noun)	På Karolinska Institutet i Stockholm hör man nästan bara engelska på fikapauserna. 
samtlig (prounoun)	Från 2000 finns det 17 olika nationella program, samtliga är treåriga. 
instruktion (noun)	Glöm inte läsa instruktionerna först. 
armé (noun)	Värnplikten gör man inom det militära försvaret, inom armén, marinen eller flygvapnet. 
instrument (noun)	Hon är mest musikalisk också och sjunger och spelar flera instrument. 
sand (noun)	Den långa munnen använder den, när den letar mat i sanden. 
artikel (noun)	Det var han som fotograferade mig till den där löjliga artikeln. 
artist (noun)	Flera världsberömda artister och grupper är svenska, men många vet inte det, för de sjunger på engelska. 
sann (adjective)	B Nej, det är sant. 
intelligent (adjective)	Jag är intelligent och arbetsam. 
intensiv (adjective)	Efter ett par timmars intensivt arbete känner han sig rätt nöjd. 
ask (noun)	får du gärna ta med dig blommor, en ask choklad eller en flaska vin. 
internetcafé (noun)	Förutom när man hittar ett internetcafé och kan hotmejla hem om solskador och billig sprit. 
astma (noun)	Först trodde jag att de hade astma. 
schack (noun)	På fritiden spelade jag schack och fotboll. 
astronom (noun)	Hans flickvän, Lena, är astronom på Esrange, rymdforskningsstationen. 
schackpjäs (noun)	med de jättestora schackpjäserna. 
intervjua (verb)	Studenttidningen har intervjuat några utbytesstudenter i Sverige. 
schampo (noun)	Förlåt mig, var finns schampo? 
schema (noun)	Nej, vårt schema är hopplöst. 
intet (prounoun)	kuvas av intet i världen. 
schweizisk (adjective)	Han har ett schweiziskt armbandsur. 
schyst (adjective)	Det är fint att se hur killarna utvecklas inte bara i fotboll utan också socialt till schysta lagkamrater. 
intresse (noun)	Hon var tvärtom mycket mångsidig och ägnade sig med ovanligt stort intresse åt konst och filosofi. 
auktionshus (noun)	I lördags sålde man en tavla för 1,5 miljoner på auktionshuset i Uppsala. 
intresseförening (noun)	Massor av människor går på bio, teater, diskotek, dansrestauranger (dansbandsmusik är mycket populär) eller är med i intresseföreningar. 
aula (noun)	De kommer fram strax före klockan åtta och går in i aulan. 
automat (noun)	Och det finns automater. 
se om (vbm)	Det är t ex lätt att se på en människa om hon är glad eller ledsen. 
inträffa (verb)	Jag undrar hur många olyckor som inträffar på grund av att det finns för få parkeringsplatser. 
av (pl)	Mamma tog av skorna med en trotsig blick. 
seans (noun)	Så är seansen över. 
invandrare (noun)	En invandrares enda chans att komma in i gemenskapen är att gifta in sig. 
sedan dess (abm)	Han debuterade 1954 och har sedan dess varit en central figur i svensk diktning. 
segelfartyg (noun)	När de kommer fram går de direkt till af Chapman, ett stort gammalt segelfartyg, som ligger mittemot Slottet. 
avdelning (noun)	Det finns många avdelningar på ett varuhus: en parfymavdelning, en sportavdelning, en elavdelning, en skoavdelning osv. 
segling (noun)	Aktiviteter vi erbjuder är segling, paddling, vandring och utflykter till stadens sevärdheter. 
sekreterare (noun)	Hon är sekreterare och arbetar på en resebyrå i Norrköping. 
avgiftsfri (adjective)	Det blir vanligare och vanligare med fristående skolor, som liksom de kommunala skolorna är avgiftsfria. 
sekund (noun)	På sekunden halv sju ringde de första gästerna på dörren. 
ironisk (adjective)	Gunnar: Nu ska du inte vara ironisk. 
semesterresa (noun)	Jag använde pengarna till en semesterresa i augusti. 
is (noun)	Luften blir till is i näsan, när man andas. 
isbar (noun)	I isbaren minglar folk från alla delar av världen och man dricker drinkar i glas av is från älven. 
avlägga (verb)	På nyårsafton ska man avlägga nyårslöften. 
avlång (adjective)	Folk ligger ju som packade sillar över hela vårt avlånga land! 
sen (adjective)	Alla bor i en by som vid den senaste folkräkningen hade 191 invånare. 
ishotell (noun)	Varje vår smälter Ishotellet sakta men säkert ner i Torne älv. 
avocado (noun)	Först går hon till ICA, för där har de extrapris på frysta räkor och avocadon är billig. 
senhöst (noun)	Och varje senhöst, i november, bygger man upp det igen. 
iskonst (noun)	Då gjorde japanska konstnärer en utställning med iskonst i Jukkasjärvi, 20 mil norr om polcirkeln. 
separat (adjective)	Skriv på separat papper. 
september (noun)	Lilla Linnea föddes den 14 september förra året. 
avskaffa (verb)	Vänsterpartiet (v) är ett socialistiskt parti, som vill avskaffa vänster kapitalismen och klassamhället. 
serie (noun)	När serien kommer på tv är du 
avsky (verb)	Fråga: Vad avskyr du? 
serietidning (noun)	KLARA: Men du kan väl läsa en serietidning för mig då? 
istället (adverb)	De har djur istället, t.ex. kor, svin, får, höns och kycklingar. 
servera (verb)	Ali tänker servera typisk tunisisk mat: mycket fårkött, ris, bönor och grönsaker. 
avsluta (verb)	När man avslutat ett uppdrag, hur mår egentligen kroppen och hur gör du för att återhämta dig? 
it-avdelning (noun)	Koden får du från it-avdelningen. 
service (noun)	Pia: Nej, man behöver inte ge dricks, men man brukar lämna lite extra om servicen är bra. 
it-företag (noun)	Här ligger många IT-företag och här jobbar Singh och många andra utlänningar. 
servitör (noun)	Servitören: Det röda är tyvärr slut, men vi har vitt vin. 
sevärdhet (noun)	Hon gav honom information om sevärdheter, restauranger och annat som är svårt att hitta pa. 
sextiden (noun)	Vi äter vid sextiden ungefär. 
ja-sida (noun)	Ja-sidan vann med 52,3 procent mot nej-sidans 46,8 procent. 
sexåring (noun)	Kommunerna är också skyldiga att erbjuda alla sexåringar plats i en förskoleklass. 
ja visst (inm)	Ja visst ja, där ligger mitt! 
jacka (noun)	När Klara kommer till dagis, måste hon ta av stövlar, sockor, vantar, jacka, byxor, halsduk och mössa. 
axel (noun)	Kvinnan i mitten har en vit sjal på huvudet och en över axlarna. 
b (noun)	B: Har du gjort något arbete? 
baby (noun)	Innan vi går och tittar på babyn, ska doktorn titta på ditt öga. 
jaja (interjection)	Kajsa: Jaja, men min ryggsäck då? 
jaktkompis (noun)	Algen har Kurt-Allan skjutit med sina jaktkompisar. 
bad (noun)	Visst är det härligt att uppleva nya kulturer och njuta av sol och bad. 
badkar (noun)	Ett badrum/wc med badkar, tvättställ och kakel samt ett WC med toalett, tvättställ och kakel. 
sill (noun)	Till exempel färsk nykokt potatis och inlagd sill ... och så en liten snaps till! 
badrumsskåp (noun)	Han hittar sin/febertermometer i badrumsskåpet och ' tar tempen *. 
jazzfestival (noun)	5 gå på Jazzfestivalen på Skeppsholmen 
simhall (noun)	Inte i havet naturligtvis utan i simhallen! 
simma (verb)	Ibland badade vi och simmade efter kanoten, och ibland fiskade vi. 
simmare (noun)	Alla älgar är duktiga simmare. 
simtur (noun)	De vaknar framåt eftermiddagen, badar bastu och tar en simtur. 
bakterie (noun)	Hon älskar att studera bakterier! 
jobbig (adjective)	Det är ganska jobbigt att sköta ett akvarium. 
singel (noun)	Hon är singel och gillar att sporta på fritiden. 
singelhushåll (noun)	Sverige är det land i Europa som har flest singelhushåll. 
jogga (verb)	Han joggar max 5 minuter i veckan eller åker skidor på vintern. 
balk (noun)	Balk, ö spis, sep wc. 
balkong (noun)	En del har balkong och öppen spis. 
jollra (verb)	Hon kan både sitta och jollra, men hon har inte lärt sig säga några ord än. 
jord (noun)	Det finns siffror som säger att det på jorden sker 80.000 starter och landningar per dygn. 
jordbruk (noun)	Bara drygt 2 procent av alla svenskar arbetar inom jordbruket. 
sist (adverb)	Till sist fick jag hennes telefonnummer, och vi snackade om allt, dygnet runt ... 
baltisk (adjective)	Sofia åkte med sin kör på turné till de baltiska länderna. 
jordgubbe (noun)	Dansar kring midsommarstången och äter sill 4 och nypotatis och jordgubbar på midsommarafton. 
jordgubbsfeber (noun)	Från juni till augusti är det jordgubbsfeber i Sverige. 
band (noun)	Det finns många böcker som är inlästa på band. 
situation (noun)	Ibland kan ett av språken vara det känslomässigt starkare och framkalla kodväxling i laddade situationer. 
jovisst (interjection)	jovisst, vi säger bara det vi tycker och menar. 
bankomatkort (noun)	Har du inget bankomatkort? 
sjal (noun)	Kvinnan i mitten har en vit sjal på huvudet och en över axlarna. 
banta (verb)	och tyst lovar man att sluta röka eller att börja banta eller någonting annat. 
ju desto (knm)	Ju högre växel du lägger i desto mindre bränsle drar bilen. 
sjukdom (noun)	Men här ... här ser jag sjukdom. 
bar (noun)	Vi var på en bar ... 
juice (noun)	Alla skålar med varandra, och de som inte dricker brännvin skålar i lättöl eller juice. 
sjuksköterska (noun)	Han är sjuksköterska och är gift med en kvinna som heter Camilla. 
julbord (noun)	och lutfisk från julbordet den 24 december. 
juldagsmorgon (noun)	Går i julotta på juldagsmorgonen. 
sjunka (verb)	1999 hade det sjunkit till 10, 0, vilket är lågt jämfört med t.ex. våra nordiska grannländer. 
barnbidrag (noun)	Dessutom hade hon en pension och barnbidrag ; tillsammans 600 kronor i månaden. 
julklapp (noun)	Jag fick En svensklärares dagbok i julklapp och den sträckläste jag. 
jullov (noun)	Sedan har elever och lärare jullov i tre veckor ungefär. 
barnmorska (noun)	BARNMORSKAN: Det är normalt. 
självklar (adjective)	Mycket tyder på att det fortfarande inte är helt självklart att nia. 
barnpassning (noun)	Deras föräldrar hjälper dem med pengar och barnpassning. 
julotta (noun)	Går i julotta på juldagsmorgonen. 
barnslig (adjective)	EMIL: Nej, det är ju barnsligt! 
barnstol (noun)	Fabian sitter i en hög barnstol vid bordet och Hassan matar honom. 
jultomte (noun)	Har jultomte, julklappar och äter skinka, rödkål 
barnvagn (noun)	Då ser de att barnvagnen är trasig. 
sjättedel (noun)	En stor del av Sverige, cirka en sjättedel, ligger ovanför polcirkeln. 
bas (noun)	Potatisen är basen i svensk mat och många svenskar äter potatis varje dag. 
juridik (noun)	I höst ska Axel börja studera juridik på universitetet i Lund, så nu måste han hitta en bostad där. 
jurist (noun)	Nu är jag färdig jurist och jobbar på en advokatbyrå. 
juristlinje (noun)	När jag var färdig med komvux började jag på juristlinjen. 
bastu (noun)	De vaknar framåt eftermiddagen, badar bastu och tar en simtur. 
basutbildning (noun)	De ger en bred basutbildning och behörighet att studera på universitet eller högskola. 
skada (verb)	Pojkens pappa kör bil med sprit i kroppen, krockar och skadar den andra bilisten. 
be (verb)	Mäklaren: Men det finns ingen centralvärme och inget varmvatten och inget bad heller förstås. 
skaffa (verb)	Samtidigt som medelåldern för att gifta sig har stigit har det blivit vanligare att vänta med att skaffa barn. 
skaffa sig (vbm)	Jonas: Då kanske det är en IT-utbildning du ska skaffa dig. 
jämföra (verb)	Jämför följande information med hur det är i ditt land. 
skaka hand (vbm)	Först skakar han hand med Sir Malcolm och önskar honom välkommen. 
jämlikhet (noun)	Socialdemokraterna (Sveriges socialdemokratiska arbetareparti) (s) vill verka för social och ekonomisk jämlikhet. 
jämn (adverb)	Det blir 35 kronor jämnt! 
bedövning (noun)	Kan jag få bedövning? 
bedövningsspruta (noun)	Syster, gör i ordning en bedövningsspruta. 
jämt (adverb)	Han glömde jämt allting och lånade alltid pengar av oss. 
skandinavisk (adjective)	De skandinaviska länderna samt Finland och Island kallar man Norden. 
befolkning (noun)	Man räknar med att 15-25 procent av befolkningen är typiska B-människor medan bara 10-15 procent är A-människor. 
skapa (verb)	Han skapade Ikea från grunden med två tomma händer hemma i Småland. 
järn (noun)	Sverige det är rena gator, gröna parker, rika naturtillgångar: skogar, järn, älvar. 
skatt (noun)	Hon betalade 500 kr i skatt och använde omkring 500 kr i månaden till mat. 
järnväg (noun)	På 1880-talet byggde man de första järnvägarna i Sverige och vi började använda telefonen. 
järnvägsstation (noun)	Nästa morgon vaknar hon klockan åtta, och efter en halvtimme rullar tåget in på Kiruna järnvägsstation. 
jättearg (adjective)	Han har åkt tåg i fem timmar och han är jättearg. 
jättebra (adjective)	Du fick ju i alla fall sagt det du ville och det var jättebra att du vågade. 
jättedyr (adjective)	Det är jättedyrt med motorcykel. 
jättefin (adjective)	Gården ser jättefin ut. 
jättegod (adjective)	Här är en jättegod Västerbotten, extralagrad. 
jättegullig (adjective)	Och så har jag träffat en jättegullig kille i cafeterian. 
jättehungrig (adjective)	Far: Men nu är jag jättehungrig! 
jättehög (adjective)	Thomas: Jamen, månadsavgiften var ju jättehög på lägenheten, 
behålla (verb)	Hur länge ska vi behålla kärnkraften? 
jättekul (adjective)	Daniel: Det skulle vara jättekul, men jag har inget pass med mig. 
behörighet (noun)	De ger en bred basutbildning och behörighet att studera på universitet eller högskola. 
jättelätt (adjective)	Anders: Självklart, det är jättelätt! 
beklaga (verb)	Växeln: Beklagar, men hon är på lunch. 
skidtur (noun)	Familjen Blomkvist i Umeå tar en skidtur. 
jätterolig (adjective)	Berit: Det är jätteroligt att ha dig här. 
jättesal (noun)	Jag drömde om en jättesal, där statsmän satt på rad 
jättestor (adjective)	Vårt labb är jättestort, nästan för stort. 
skinka (noun)	Har jultomte, julklappar och äter skinka, rödkål 
jättesöt (adjective)	KLARA: Ja, han är jättesöt. 
ben (noun)	Älgen har långa ben och kort hals och älgtjuren har stora horn. 
bero (verb)	Men det beror kanske på att den handlar om två människor som råkade bli mina föräldrar. 
skiva (noun)	På de större biblioteken kan man också lyssna på musik eller låna hem skivor. 
k (noun)	Charmig br, (b.1922), 98 kvm, 4 r o k mitt i stan. 
berätta (verb)	Myten berättar att Kristina kastade sig upp på sin häst och red iväg söderut. 
kabel (noun)	Det var en massa kablar och sladdar. 
skivstång (noun)	Skivstången lägger han under sängen och högtalarna ställer han på golvet. 
kabelnät (noun)	Ansluten till kabelnät mot avg 
kabelteve (noun)	Vi har ju fått kabelteve och våra barn tittade tills ögonen blev fyrkantiga under julen. 
skjuta (verb)	Där bor deras lärare, och de ska få skjuts dit av Millans pappa i hans minibuss. 
kaffe latte (nnm)	Den kan göra riktig kaffe latte. 
kaffeapparat (noun)	Det är vår nya kaffeapparat. 
beskriva (verb)	Själv tycker hon det är tråkigt att singelmammorna ofta beskrivs som egoistiska och kräsna karriärkvinnor som vill ha allt. 
skoavdelning (noun)	Det finns många avdelningar på ett varuhus: en parfymavdelning, en sportavdelning, en elavdelning, en skoavdelning osv. 
beställa (verb)	Du måste beställa tid. 
beställning (noun)	Någon måste väl ta hand om alla beställningarna på Internet också? 
bestämma (verb)	Han ensam bestämmer över ord och regler. 
bestå (verb)	I dag består cirka hälften av alla hushåll i Sverige av en person. 
kaka (noun)	Och vi har faktiskt hembakade kakor som Lena i köket har bakat. 
kakao (noun)	Du, var finns kakao? 
kakel (noun)	Ett badrum/wc med badkar, tvättställ och kakel samt ett WC med toalett, tvättställ och kakel. 
besvär (noun)	Vad har du för besvär? 
skoj (noun)	Ha det så skoj. 
skoja (verb)	Nej jag skojar bara, men jag sopsorterar i alla fall. 
besöka (verb)	Sista gången hon besökte dem kunde de stolt visa upp sin förstfödde son. 
besökare (noun)	Där kan våra besökare bada och varje vardagsmorgon klockan nio har vi vattengympa. 
kalla (verb)	De har kommit att kallas de nya pendlarna eller pingpongbarn. 
kalori (noun)	Då får du vitaminer, proteiner och lagom med kalorier. 
kalv (noun)	Varje år i maj-juni föder älgkon en eller två kalvar. 
skoldag (noun)	Äntligen är skoldagen slut, och eleverna får gå hem, många fortfarande med glitter i håret. 
skolelev (noun)	Det är också vanligt att skolelever sitter och studerar på biblioteket. 
kamel (noun)	Men för en tid sedan såg de i en tidning att det fanns en djurpark med kameler på Oland. 
kamelskötare (noun)	Vad har en somalisk kamelskötare för chans att hitta jobb i Sverige? 
betoning (noun)	Hette tidigare Bondeförbundet och är fortfarande ett landsbygdsparti med betoning på miljöfrågor. 
skolform (noun)	De som hoppar av skolan kan fortsätta senare och läsa på KOMVUX, en skolform för vuxna. 
betrakta (verb)	Han är alldeles ensam och betraktar alla som sitter tillsammans. 
kameraväska (noun)	Du får det här stativet och kameraväskan för 1 400! 
betydelse (noun)	Jag tänkte mycket på språkets betydelse när jag var liten. 
kamma (verb)	Han kommer att stå och kamma sig och spegla sig. 
skolka (verb)	Knut: Så du skolkade inte ...? 
kammare (noun)	Riksdagen har en kammare med 349 platser. 
betyg (noun)	För några utbildningar måste man ha mycket höga betyg från gymnasiet. 
skolklass (noun)	Tidningen Aftonposten frågade barnen i en skolklass i Göteborg: Vad vill du bli när du blir stor? 
beundra (verb)	Fråga: Vilken nu levande person beundrar du? 
kamrat (noun)	Han parkerar bilen utanför porten och bär tillsammans med en kamrat upp allting och ställer det i korridoren. 
bibliotekarie (noun)	Han lämnade fram travar med böcker men bibliotekarien förklarade att man högst fick låna tre åt gången. 
skoltid (noun)	Skoltiden var svår för han var dyslektiker. 
kanin (noun)	Hur mår din lilla kanin? 
kanna (noun)	Sedan tar du 12 skopor per kanna. 
skomakare (noun)	Gå till skomakaren och hämta mina svarta stövlar. 
bilda (verb)	På vintern är solens strålar för svaga för att kunna bilda något vitamin i huden. 
skopa (noun)	Sedan tar du 12 skopor per kanna. 
bilfärja (noun)	De ska ta en bilfärja till ön. 
kantarell (noun)	När de har fikat, går de ut i skogen och plockar blåbär och kantareller. 
kantarellsmörgås (noun)	Berit: Om vi hittar kantareller, ska vi göra kantarellsmörgåsar. 
skoskydd (noun)	När Rolf och Annika kommer in i lägenheten måste de sätta på sig blåa skoskydd av plast över skorna. 
bilist (noun)	Den ställer de flesta bilister upp på både i teorin och praktiken. 
kapitalism (noun)	Vänsterpartiet (v) är ett socialistiskt parti, som vill avskaffa vänster kapitalismen och klassamhället. 
skrapa (verb)	EMIL: Ja, jag tvättade, skrapade, spacklade, slipade och målade. 
bilolycka (noun)	Det var en bilolycka. 
skraplott (noun)	Ett paket cigaretter, en skraplott och ett paket saffran också, tack. 
bilskola (noun)	Det är dyrt att ta lektioner på en bilskola. 
bilverkstad (noun)	Det trodde aldrig min mamma för 15 år sedan när jag jobbade på en bilverkstad. 
binda (verb)	Kanske binder jag mig när jag blir äldre, typ 32. 
binda ihop (vbm)	Den 1 juli 2000 öppnade man Oresundsbron som binder ihop Sverige och Danmark. 
skrika (verb)	Då skriker hon: Tjata inte! 
skriva ner (vbm)	Har du skrivit ner din adress? 
skriva ut (vbm)	Jag skriver ut ett recept på lite medicin. 
karaoke (noun)	Har du sjungit karaoke någon gång? 
karat (noun)	Här har vi ett par äkta guld och diamanter i 18 karat! 
bit (noun)	Kunden: Kan jag få ... halva den där biten? 
bita (verb)	Huggormar biter sällan människor. 
skrivning (noun)	Han åt en smörgås till mellanmål, och sedan gjorde han läxorna läsning, skrivning eller en psalmvers. 
karl (noun)	GUNILLA: Jag tycker om en annan karl! 
björn (noun)	Björnen sover, björnen sover 
skrot och korn (nnm)	Anders: Anders Mattson på Skrot och Korn. 
björnspår (noun)	Vi tror att det var björnspår. 
skruva (verb)	Det tar nog hela kvällen att skruva ihop den, tror Daniel. 
bland (preposition)	Vid bordet rådde dödstystnad bland barnen och fadern talade mycket lite. 
skryta (verb)	Utan att skryta måste jag säga att jag köper i stort sett allt jag vill. 
blanda (verb)	Det gröna gräset ser jag också, konstigt nog, eftersom jag brukar blanda ihop grönt, rött och brunt. 
kartong (noun)	HASSAN: Nej, det har jag inte gjort, men jag har packat upp den och kastat kartongen. 
karusell (noun)	Bland karuseller, berg- och-dalbanor, stånd med pilkastning, lotterier och varmkorv sitter en spågumma i ett tält. 
blank (adjective)	Den var i perfekt skick och alldeles skinande blank. 
blankett (noun)	Du kanske kan hjälpa mig att fylla i blanketten. 
kasino (noun)	Jag är croupier på ett kasino. 
skräckhistoria (noun)	Det cirkulerar många skryt- och skräckhistorier om hur det är och var att göra lumpen. 
blek (adjective)	Hon ser lite blek ut. 
skrämma (verb)	Men det skrämde henne, så hon skrev ingenting förrän hon hade hunnit bli 37 år. 
kassettbok (noun)	Så här stod det i en annons för kassettböcker, som vi såg i en tidning häromveckan: 
kasta (verb)	klumpigt åt, men genomskådades och kastades tillbaka. 
bli över (vbm)	Ingen tid blir det över till familjesammankomster heller. 
skuld (noun)	Hon försökte förklara att hon inte vill ha mer skulder just nu. 
kasta ut (vbm)	Kastar ut granen på tjugondag Knut. 
kastrull (noun)	Han har inte diskat kastrullerna och han har glömt att lämna in tipset. 
kastspö (noun)	Gunnar: Vad tyckte du om kastspöet som Magnus fick av oss grabbar? 
katalog (noun)	Katalogerna visade möblerna i ett riktigt hem. 
blodpudding (noun)	Till vänster om blodpuddingen. 
sky (noun)	jag sett vildgässens sträck under kvällande sky. 
blommig (adjective)	Hon har en vit blus och över den en blommig väst, som är gul och röd. 
skyldig (adjective)	Kommunerna är också skyldiga att erbjuda alla sexåringar plats i en förskoleklass. 
skylt (noun)	står det på en skylt ovanför tältöppningen. 
kebabkiosk (noun)	I varje svensk liten stad finns tre restauranger: en pizzeria, en kebabkiosk och en kinesisk restaurang. 
blus (noun)	Hennes blus är också vit, men västen är blå med ljusblåa blommor. 
blyg (adjective)	Många av lärarna tyckte inte om arbetarbarn, och jag var blyg och rädd och slutade efter tre år. 
bläddra (verb)	Ann sitter i flygplanet och bläddrar i några vackra broschyrer om Sverige, svensk kultur 
skynda sig (vbm)	Klockan var redan halv sju och han måste skynda sig. 
skägg (noun)	Jag ska raka av mig skägget! 
blåbär (noun)	Helena: Där borta växer det blåbär, ser jag! 
blåbärspaj (noun)	Kurt-Allan bakar en blåbärspaj när de kommer hem. 
blåbärssoppa (noun)	Det går åt mängder av blåbärssoppa, 5 500 liter ungefär. 
kemist (noun)	Den 10 december 1896 dog kemisten och uppfinnaren Alfred Nobel. 
blåsa (verb)	Fjädrarna bevarar kroppsvärmen, men om det blåser, eller om de blir våta, kan de börja frysa. 
ketchup (noun)	Och jag har sett att en del äter ketchup till pasta. 
blöda (verb)	Det blöder från höger ögonbryn men Klara gråter inte, fastän det gör mycket ont. 
kg (noun)	Älgkalven väger cirka 10 kg när den föds och efter en vecka orkar den springa ifrån en människa. 
blöt (adjective)	Maja Alla sommarkläderna och lådorna med minnen från när barnen var små har blivit blöta och antagligen helt förstörda. 
bo (noun)	medan storkarna redde sitt bo. 
skär (adjective)	Hon har en mörkgrön kjol och över den ett skärt förkläde. 
boende (noun)	Det finns även s.k. folkhögskolor, som erbjuder både studieplats och boende. 
kilo (noun)	Då vägde hon bara 3,2 kilo och var liten som en docka. 
skärgårdsbåt (noun)	Många tar också en tur med de vita skärgårdsbåtarna. 
kilometer (noun)	Han hade fem kilometer till sågverket och måste gå hela vägen. 
boka (verb)	John har bokat ett billigt rum på ett enkelt hotell. 
skärp (noun)	Lina: Det där är mitt skärp! 
kines (noun)	Fatoush presenterade nya, intressanta idéer för kineserna. 
boklån (noun)	Ca 66 miljoner boklån/år. 
skådespelare (noun)	Jag ska bli kändis, popsångare eller skådespelare, som Brad Pitt. 
skål (noun)	Så tänder man en cigarr, häller upp ett glas champagne och skålar. 
skånsk (adjective)	Jag älskar typisk skånsk mat som sill, ål och spettekaka. 
bolag (noun)	Nästan alla arbetar på LKAB, ett gruv- bolag. 
bonde (noun)	Det finns inte så många bönder i Sverige. 
skörd (noun)	jag sett skördarna gro på min torva i ro, 
sköta (verb)	Under civilplikten får man lära sig hur viktiga uppgifter i samhället sköts i en krigssituation. 
klara sig (vbm)	Därför måste fåglarna klara sig utan vatten. 
sköterska (noun)	En sköterska svarar, och Daniel säger att han inte mår bra. 
slag (noun)	I det här ögonblicket vilar ett slags nyväckt samförstånd mellan oss. 
klassamhälle (noun)	Vänsterpartiet (v) är ett socialistiskt parti, som vill avskaffa vänster kapitalismen och klassamhället. 
borta (pl)	Ägaren tänker vara borta i två år. 
klasskamrat (noun)	Du sitter kanske hemma i din fåtölj eller så är du i ditt klassrum tillsammans med dina klasskamrater. 
bostad (noun)	Men samtidigt hade han en egen firma hemma i bostaden. 
slang (noun)	Ingen vet riktigt hur detta kunde hända, men kanske hade någon kopplat slangarna fel. 
bostadsannons (noun)	Thomas hämtar dagens tidning med bostadsannonser. 
klicka (verb)	Anders: Du klickar bara på den här knappen skicka. 
klimat (noun)	Båda älskar Italien ; klimatet, musiken och konsten men också maten och vinet. 
bostadsrätt (noun)	Jag kan inte köpa någon bostadsrätt. 
slarva (verb)	Många personer slarvar med maten. 
slarvig (adjective)	Han var jättetrevlig, men slarvig. 
brand (noun)	Man får göra upp eld (om det inte finns risk för brand). 
slipa (verb)	EMIL: Ja, jag tvättade, skrapade, spacklade, slipade och målade. 
brandsläckare (noun)	En brandsläckare har de också, förstås! 
slippa (verb)	Han är ganska uppåt för han tycker det är skönt att slippa köra på natten. 
slips (noun)	Nu står han framför spegeln och knyter slipsen. 
brasa (noun)	C: Vi går väl till brasan som vanligt. 
bre (verb)	Ishotellet kan ta emot 130 nattgäster, som sover i sovsäckar på djurhudar som breds ut över issängar. 
klippa sig (vbm)	Jag ska klippa mig! 
bred (adjective)	De ger en bred basutbildning och behörighet att studera på universitet eller högskola. 
breddgrad (noun)	Stockholm ligger på samma breddgrad som Grönlands sydspets och Alaska och Sibirien. 
slottsstek (noun)	Sedan äter de mamma Brittas goda slottsstek med kokt potatis, lingon, gurka och brun sås. 
brevvän (noun)	Anna: Jag har en svensk brevvän. 
brinna (verb)	Om det blir brand kan ju allt brinna upp. 
slut (noun)	Någon gång i slutet av 60-talet och början av 70-talet föddes den nya samlevnadsformen: samboförhållandet. 
slutligen (adverb)	Till middag, slutligen, äter du däremot en lätt måltid med mycket grönsaker. 
broms (noun)	Det var något fel på bromsarna på bilen. 
bromsa (verb)	Medan testgruppen gjorde dessa saker mättes deras reaktionstider när de bromsade in eller måste stanna för rött ljus. 
släcka (verb)	Jag sparar energi genom att alltid släcka lamporna i rum som jag inte är i. 
brorsa (noun)	Fredrik:Ja, jag väntar på min brorsa. 
brosch (noun)	G: Nej, jag behöver en brosch också. 
släkting (noun)	Då åker de till Spanien eller till släktingar på landet. 
klä (verb)	Sedan tog han fram rena underkläder och strumpor och en ny, vit skjorta och klädde på sig. 
slänga (verb)	Jag har inte slängt instruktionen. 
brun (adjective)	Plötsligt står en ung man där, långhårig, orakad, klädd i en smutsig, brun kostym. 
klämma (verb)	Han masserade en fot i taget och klämde och tryckte. 
klättra (verb)	Klara klättrar på en stor sten, och hon skrattar och är lycklig. 
brygga (verb)	I köket står några trötta ungdomar och brygger kaffe och värmer upp lussekatter i ugnen. 
knapp (noun)	Tryck in koden här och tryck sedan på den gröna knappen. 
brännvin (noun)	Alla skålar med varandra, och de som inte dricker brännvin skålar i lättöl eller juice. 
slå upp (vbm)	Han slår upp de blåa sidorna 
slå ut (vbm)	Rosor slår ut i den hårdaste mark 
bråka (verb)	Efteråt pratade vi i klassen om hur man ska göra när man bråkar för att få slut på bråket. 
bråkig (adjective)	Jag vill inte ha några bråkiga grannar. 
knyta (verb)	Nu står han framför spegeln och knyter slipsen. 
smak (noun)	Agneta Vi har olika aktiviteter för alla smaker. 
knä (noun)	Jag satt i en soffa och lade upp fötterna i knät på honom. 
smaka (verb)	Helena: Har du smakat på bären? 
bröllopsdag (noun)	Firar bröllopsdagen på pingstafton. 
bröllopsresa (noun)	De åkte på bröllopsresa i Sofias gamla Volvo till Tobias mormor i Gränna. 
smaklök (noun)	Vill du testa dina smaklökar? 
knäckebröd (noun)	Knäckebröd, sill, lax, räkor, köttbullar ... 
bud (noun)	Man kunde också skicka bud. 
ko (noun)	Varje ko ger i genomsnitt cirka 8 400 liter mjölk per år. 
buffé (noun)	Kom till Chiliparadiset och ät av vår stora buffé. 
buga (verb)	Han bugar för dem och säger: 
kod (noun)	Tryck in koden här och tryck sedan på den gröna knappen. 
kokbok (noun)	Vill du också ha en kokbok? 
bussresa (noun)	Det var en bussresa till Italien. 
butik (noun)	Man räknar med att öppna tio nya butiker om året. 
kolla upp (vbm)	Det måste han kolla upp. 
by (noun)	Han berättade att han kom från en by trettiofem mil norr om Överkalix. 
bygga (verb)	Om resenärer tänkte om och järnvägsspåren byggdes ut skulle vi ha ett mycket klimatsmartare samhälle. 
smutsig (adjective)	Min hund blir så smutsig om tassarna när det regnar och vi tar vår dagliga promenad. 
byggföretag (noun)	Jag ska arbeta på ett svenskt byggföretag. 
byggnadsingenjör (noun)	Hans från Nederländerna studerar till byggnadsingenjör i Amsterdam. 
koloni (noun)	Samtidigt sitter Oscar och Margrete Sandström och dricker kaffe i solen i sin koloni i Lund. 
smällare (noun)	Unga och gamla studenter sätter på sig vita studentmössor, barn kastar smällare och ibland har man fyrverkeri. 
kolonilott (noun)	Och många har kvar sina kolonilotter. 
smälta (verb)	Varje vår smälter Ishotellet sakta men säkert ner i Torne älv. 
bykort (noun)	Här kommer ett bykort från 
komma igen (vbm)	Men han kommer igen. 
bänk (noun)	Daniel och Jonas sitter på en bänk i Kungsträdgården och pratar med Aldis och Juris från Lettland. 
bär (noun)	De tänker plocka bär. 
bära sig (vbm)	Bär ner mig till sjön! 
bäst som (abm)	Skrattar bäst som skrattar sist! 
komma ut (vbm)	Om man bryter av någon av de många taggarna på kroppen, kommer giftet ut. 
komma överens (vbm)	1991 kom de svenska och danska regeringarna till slut överens om en bro- och tunnelförbindelse. 
både och (knm)	Den ställer de flesta bilister upp på både i teorin och praktiken. 
båttur (noun)	3 ta en båttur ut i skärgården 
böckling (noun)	Rökt strömming heter böckling. 
småstad (noun)	Ska man bo i lägenhet eller i villa, på landet, i småstad, i storstad eller i förort? 
kommun (noun)	Det är en stor kommun till ytan, men bara cirka 25 000 bor där. 
kommunal (adjective)	Det blir vanligare och vanligare med fristående skolor, som liksom de kommunala skolorna är avgiftsfria. 
bölja (verb)	Inne i lägenheten böljar de sjunga, först lite falskt men sedan låter det riktigt vackert: 
böna (noun)	Ali tänker servera typisk tunisisk mat: mycket fårkött, ris, bönor och grönsaker. 
kommunalval (noun)	I valet till riksdagen får bara svenska medborgare rösta, men i kommunalvalen kan utlänningar också vara med. 
böra (verb)	Andra tycker att vi bör behålla det demokratiska och väl förankrade du. 
smör (noun)	Hon köper också ett halvt kilo smör, ägg, en bit ost och två liter mjölk. 
börsmäklare (noun)	Då ska jag söka jobb som börsmäklare i London. 
snabb (adjective)	Många gånger har Anna tänkt på den lilla papperslappen hon gav Gary vid deras första snabba möte i England. 
cafeteria (noun)	Och så har jag träffat en jättegullig kille i cafeterian. 
campa (verb)	Många campar i tält eller husvagn, har båtar, fritidshus eller kolonilotter. 
campingkök (noun)	Tält, sovsäckar, campingkök och vara flöjter hade vi med oss. 
cappuccino (noun)	En dag i januari sitter Hanna och Emil och dricker cappuccino på nya kafé Stella. 
snabbmat (noun)	Stress och snabbmat är inget som vi mår bra av. 
cd (noun)	Lyssna mycket på textbokens cd. 
cd-spelare (noun)	Trots att de inte hade mycket pengar köpte de en CD-spelare och en dator. 
snabel-a (noun)	Brian: Vad är snabel-a för något? 
snacka (verb)	Sedan går vi och tar en öl och snackar lite grand, va? 
centerparti (noun)	Centerpartiet (c) är ett mittenparti. 
centimeter (noun)	Han är 179 cm (centimeter) lång, mellanblond och ganska tystlåten. 
central (adjective)	Han har precis kommit till Stockholms central. 
centralvärme (noun)	Mäklaren: Men det finns ingen centralvärme och inget varmvatten och inget bad heller förstås. 
centrum (noun)	Här har vi ju en stor etta i ett gammalt hus nära centrum. 
champagne (noun)	Så tänder man en cigarr, häller upp ett glas champagne och skålar. 
chans (noun)	Det här är din chans. 
charmig (adjective)	Charmig br, (b.1922), 98 kvm, 4 r o k mitt i stan. 
charterresa (noun)	Cirka 1 miljon svenskar åker utomlands på charterresor per år. 
chefsekonom (noun)	Olof Svensson, chefsekonom, på Odenbanken säger att han inte är förvånad. 
koncentrera sig (vbm)	Jag gick på kurs, men jag kunde inte koncentrera mig. 
chilensk (adjective)	Servitören: Ja, vi har ett chilenskt rödvin som är mycket bra. 
konditori (noun)	Han äter alltid temlor (semlor på Ture Sventon-språk) från Rosas konditori där de bakar semlor året runt. 
chilitequila (noun)	Specialitet: chiliöl och chilitequila Vår mexikanska rockgrupp spelarl 
chiliöl (noun)	Specialitet: chiliöl och chilitequila Vår mexikanska rockgrupp spelarl 
konduktör (noun)	Jag frågar konduktören på tåget. 
choklad (noun)	Familjen tar en paus, dricker varm choklad och äter smörgåsar. 
snus (noun)	Snus är tobak som man har malt. 
snusa (verb)	Men jag snusar en hel del. 
chokladlotteri (noun)	Hon tänker pröva lyckan och köpa en lott i Chokladlotteriet. 
chokladsås (noun)	Till efterrätt blir det glass med chokladsås. 
chokladtårta (noun)	Sven: Chokladtårta för mig, tack. 
cigarr (noun)	Så tänder man en cigarr, häller upp ett glas champagne och skålar. 
kongress (noun)	Idag börjar en stor, internationell kongress i staden. 
cirkulera (verb)	Det cirkulerar många skryt- och skräckhistorier om hur det är och var att göra lumpen. 
snäll (adjective)	Du är för snäll. 
citat (noun)	Kontrollera stavning, avstavning, citat, rubrik, styckemarkering, förkortningar, kommatering m.m. Använd Svenska skrivregler utgivna av Svenska språknämnden. 
civil (adjective)	Kvinnor får också ansöka om militär eller civil utbildning. 
civilekonom (noun)	Ibland tänker jag att jag borde studera till civilekonom. 
civilplikt (noun)	Under civilplikten får man lära sig hur viktiga uppgifter i samhället sköts i en krigssituation. 
cm (noun)	Han är 179 cm (centimeter) lång, mellanblond och ganska tystlåten. 
konserv (noun)	Där finns det frukt, grönsaker, drycker, kött, konserver, bröd, mejerivaror etc. 
konservativ (adjective)	Det är ett konservativt parti. 
croupier (noun)	Jag är croupier på ett kasino. 
snöskoter (noun)	Många är ute med sin snöskoter. 
cykelförråd (noun)	I fastigheten finns Tvättstuga, Torkrum, Cykelförråd och Förråd. 
konsonant (noun)	Lyssna efter långa vokaler och konsonanter. 
konst (noun)	Båda älskar Italien ; klimatet, musiken och konsten men också maten och vinet. 
social (adjective)	Flickor umgås helst med sina vänner på sociala sajter, t.ex. Facebook. 
konstatera (verb)	Utan dem hade det inte varit roligt, konstaterar han. 
cykla (verb)	Åka kollektivt och cykla. 
socialdemokrat (noun)	Socialdemokraterna (Sveriges socialdemokratiska arbetareparti) (s) vill verka för social och ekonomisk jämlikhet. 
socialdemokratisk (adjective)	Socialdemokraterna (Sveriges socialdemokratiska arbetareparti) (s) vill verka för social och ekonomisk jämlikhet. 
socialistisk (adjective)	Vänsterpartiet (v) är ett socialistiskt parti, som vill avskaffa vänster kapitalismen och klassamhället. 
konstig (adjective)	Dina ögon ser texten och din hjärna tolkar innehållet och du tänker: Vilken konstig text! 
dag ut och dag in (abm)	Här kommer vi in, jag och andra lärare och undervisar er varje vecka, dag ut och dag in. 
dagisbarn (noun)	när alla dagisbarn sover 
daglig (adjective)	Min hund blir så smutsig om tassarna när det regnar och vi tar vår dagliga promenad. 
dagstidning (noun)	Där finns också dagstidningar från 
socka (noun)	När Klara kommer till dagis, måste hon ta av stövlar, sockor, vantar, jacka, byxor, halsduk och mössa. 
socker (noun)	EMIL: Utan mjölk men med socker. 
konsultfirma (noun)	Kristoffer är framtidsanalytiker på en konsultfirma. 
dam (noun)	säger han till alla unga damer. 
sockerbit (noun)	På morgonen äter familjen fil och flingor och Erik dricker en och en halv kopp kaffe med en sockerbit. 
damma (verb)	Så nu har Bodil en sak till att damma. 
kontakt (noun)	Visste de, mamma och min plastpappa, att jag och brorsorna har kontakt fortfarande då skulle de dö. 
kontakta (verb)	Lämna ditt namn och telefonnummer efter pipet så kontaktar jag dig sedan. 
dansbana (noun)	På dansbanan spelar orkestern vals: Que será, será. 
dansbandsmusik (noun)	Massor av människor går på bio, teater, diskotek, dansrestauranger (dansbandsmusik är mycket populär) eller är med i intresseföreningar. 
dansrestaurang (noun)	Massor av människor går på bio, teater, diskotek, dansrestauranger (dansbandsmusik är mycket populär) eller är med i intresseföreningar. 
kontinent (noun)	Sammanlagt emigrerade cirka en miljon svenskar till den amerikanska kontinenten. 
dass (noun)	Och ingen toalett, bara dass på gården. 
konto (noun)	Kontot är nästan tomt och fonderna som han sparar i har bara sjunkit på sistone. 
soldat (noun)	Men att försvara Sverige innebär mer än soldater och stridsvagnar. 
kontra (verb)	AIK kontrade 19 minuter in i matchen. 
kontrakt (noun)	Jag vill ha ett eget kontrakt! 
kontrollera (verb)	Har du kontrollerat alla tider? 
solidaritet (noun)	Det handlar också om mänskliga rättigheter, solidaritet mellan kvinnor och män och mellan olika folkgrupper och länder. 
solig (adjective)	Vädret är soligt med svag vind, cirka 10 minusgrader och en meter snö. 
datum (noun)	Vad är det för datum i dag? 
konvolut (noun)	så skrev de på ett konvolut och reste sig och sa: 
deciliter (noun)	1 1/2 deciliter mjölk eller vatten 
koppla (verb)	Jag har kopplat av. 
koppla av (vbm)	Jag har kopplat av. 
del (noun)	Barn tillbringar en stor del av sin dag i skolan eller förskolan där allt sker på landets språk. 
som bäst (abm)	Svensk modern mat när den är som bäst! 
dela sig (vbm)	Far: Vi delar på oss och letar! 
korg (noun)	Vi går in, tar en korg och går runt och tittar på alla varor och priser. 
delikatess (noun)	9 köpa svenska delikatesser 
demokrati (noun)	Midsommar, Lucia, valborgsmässoafton, första maj, kungen, drottningen, riksdagen, regeringen, demokrati, Ingmar Bergman, Björn Borg, Greta Garbo, Birgit Nilsson. 
somalisk (adjective)	Vad har en somalisk kamelskötare för chans att hitta jobb i Sverige? 
demonstrera (verb)	Vi ska ju gå och demonstrera då. 
korridor (noun)	Han hade blivit så rädd att han gömt sig bakom skåpen i korridoren. 
korsning (noun)	Vid korsningen tar du till höger och sedan går du förbi Tyska kyrkan. 
denna (dt)	Miraklen infinner sig, ganska ofta, och det är om dessa mirakel av språklig förståelse som jag vill tala. 
denna (prounoun)	Detta förvånade undersökarna, precis som det har förvånat Anna Berg och Arne Damström. 
kort (adverb)	Kort sagt, vi har ett problem, eller rättare sagt, ni har ett problem. 
kort (adjective)	Vår nervositet tilltog under den korta promenaden. 
kort sagt (abm)	Kort sagt, vi har ett problem, eller rättare sagt, ni har ett problem. 
sommarlov (noun)	På sommarlovet åkte de på semester. 
desperat (adjective)	Till sist blev läraren desperat. 
dessert (noun)	En vanlig svensk dessert är glass med varm hjortronsylt. 
dessertost (noun)	— Vill du ha en hårdost eller en dessertost? 
dessutom (adverb)	Dessutom hade jag som mål att ta för runt 1 000 kronor i veckan. 
sommarstuga (noun)	Mäklaren: Jaså, ja, då har vi en sommarstuga utanför stan. 
det vill säga (abm)	(det vill säga) alla, både kvinnor och män, fick rösta. 
korvkiosk (noun)	Jag frågar mannen vid korvkiosken. 
diamant (noun)	Här har vi ett par äkta guld och diamanter i 18 karat! 
diamantbrosch (noun)	E: Vi har en diamantbrosch här ... 
kostym (noun)	Plötsligt står en ung man där, långhårig, orakad, klädd i en smutsig, brun kostym. 
sophämtning (noun)	Man måste ju betala en massa saker varje månad, olja och sophämtning till exempel. 
digitalkamera (noun)	Hon kan mycket om datorer och hon är duktig på att fotografera med digitalkamera. 
dill (noun)	Vi äter ofta laxen gravad, dvs rå med socker, salt och dill. 
dillsås (noun)	Servitören: Varsågoda, en stekt lax med pommes frites och dillsås, en biff med romsås och ris och en fisklasagne. 
kran (noun)	När hon vred på kranen kom öl i stället för vatten. 
kranvatten (noun)	Du får bara dricka mineralvatten, inte kranvatten. 
direktmeddelande (noun)	* messa = skicka direktmeddelande till varandra på nätet eller i mobilen 
direktör (noun)	På torsdag kommer några svenska författare, och på fredag kommer några direktörer från svenska företag. 
kratta (verb)	De gräver och planterar och krattar löv och väntar på sommaren. 
dirigera (verb)	Kör du i stället, så sitter jag bredvid och dirigerar! 
sova över (vbm)	Några besökare sov över i igloon och de tyckte att det var fantastiskt. 
diskbänk (noun)	Det finns en dusch, en toalett, en spis, ett kylskåp, en ugn och en diskbänk och flera skåp. 
sovkupé (noun)	Hon har tur och får en egen sovkupé. 
diskmaskin (noun)	Det står ju faktiskt här på skylten: Ställ in disken i diskmaskinen. 
diskotek (noun)	Massor av människor går på bio, teater, diskotek, dansrestauranger (dansbandsmusik är mycket populär) eller är med i intresseföreningar. 
sovsäck (noun)	Tält, sovsäckar, campingkök och vara flöjter hade vi med oss. 
spackla (verb)	EMIL: Ja, jag tvättade, skrapade, spacklade, slipade och målade. 
diskussion (noun)	Efter diskussionen gick han tyst runt i lägenheten. 
krig (noun)	En del böcker köpte hon men en del togs som krigsbyte av svenska soldater i kriget. 
distriktsläkare (noun)	Hej, jag heter Johan Lundman och är distriktsläkare här. 
dit (adverb)	Jag har inte varit där på ett tag, men jag skulle gärna vilja åka dit snart. 
spansk (adjective)	Det vita vinet är från Sydafrika och det röda är spanskt. 
spanska (noun)	Vi hade lektion i spanska ... 
krigssituation (noun)	Under civilplikten får man lära sig hur viktiga uppgifter i samhället sköts i en krigssituation. 
djup (adjective)	2Därefter kommer ett stadium med djupare sömn och där befinner man sig halva tiden av den tid man sover. 
djur (noun)	De har djur istället, t.ex. kor, svin, får, höns och kycklingar. 
kring (preposition)	Kring jord, som sol ' n förlät, 
djurpark (noun)	Men för en tid sedan såg de i en tidning att det fanns en djurpark med kameler på Oland. 
djursjukhus (noun)	Han är hemma från djursjukhuset. 
kristall (noun)	4 handla svensk kristall 
dock (adverb)	Det behöver dock inte vara själva risken som lockar, utan upplevelsen. 
docka (noun)	Då vägde hon bara 3,2 kilo och var liten som en docka. 
dofta (verb)	Inne hos Millan är det emellertid ljust och varmt, för det står levande ljus överallt, och det doftar gott. 
doktor (noun)	Tomas: Gå till doktorn! 
doktorera (verb)	Kanske doktorerar jag i framtiden. 
kristdemokrat (noun)	Kristdemokraterna (kd) har sedan valet 1991 varit ett riksdagsparti. 
doktorsexamen (noun)	Efter examen kan man söka till forskarutbildning för att ta doktorsexamen. 
specialitet (noun)	Specialitet: chiliöl och chilitequila Vår mexikanska rockgrupp spelarl 
speciell (adjective)	Ulla-Britt Kotsinas, numera biträdande professor i nordiska språk vid Stockholms universitet, gjorde då ett forskningsarbete om ungdomars speciella gruppspråk. 
spegel (noun)	Nu står han framför spegeln och knyter slipsen. 
krocka (verb)	Totalt 10 bilar krockade. 
krog (noun)	och drog från krog till krog 
spegla (verb)	Han kommer att stå och kamma sig och spegla sig. 
dominera (verb)	Andreas Men det här är verkligen något för dig: Eftersom branschen domineras av män ser vi gärna kvinnliga sökande. 
spelare (noun)	Han stoppar cd-skivan i en ficka och cd- spelaren i en annan. 
doppa (verb)	Och när jag doppat mig 
kronprinsessa (noun)	Victoria är Sveriges kronprinsessa. 
spelman (noun)	Folkdansgrupper och spelmän använder dem ofta. 
kropp (noun)	Man ger järnet hela tiden och efter matchen är man helt slut i kroppen. 
dra (verb)	Det går inte att dra några gränser. 
dra in (vbm)	Den har burrat upp fjädrarna och dragit in halsen och fötterna. 
spettekaka (noun)	Jag älskar typisk skånsk mat som sill, ål och spettekaka. 
spis (noun)	Det finns en dusch, en toalett, en spis, ett kylskåp, en ugn och en diskbänk och flera skåp. 
spisfläkt (noun)	I köket finns spis, spisfläkt, kyl och kakel. 
kryddmått (noun)	1 1/2 kryddmått svart- eller vitpeppar 
dramatisk (adjective)	Allt gick bra, även om det var lite dramatiskt ibland. 
kryddsmör (noun)	Patrik: Och jag tar oxfilé med kryddsmör och potatisgratäng. 
sportavdelning (noun)	Det finns många avdelningar på ett varuhus: en parfymavdelning, en sportavdelning, en elavdelning, en skoavdelning osv. 
sporthatare (noun)	Jag ar en 37-årig sporthatare på Gotland 
kryss (noun)	Titta på samma sida om det finns andra ord med kryss. 
dricks (noun)	Måste man ge dricks på restauranger i Sverige, förresten? 
kryssa (verb)	Kryssa för ord som du slår upp i ordboken. 
kräfta (noun)	Serverar kräftor och surströmming i augusti. 
sportlov (noun)	Man har jullov och sommarlov men också sportlov, påsklov och höstlov. 
drink (noun)	I isbaren minglar folk från alla delar av världen och man dricker drinkar i glas av is från älven. 
driva (verb)	Alkohol får till exempel bara säljas i särskilda, statliga butiker som drivs av Nya System AB. 
springa fram (vbm)	De andra barnen springer fram till Klara. 
drottning (noun)	Här ser vi Sveriges kung, Carl XVI Gustaf, och hans drottning, Silvia, född Sommerlath. 
springa ut (vbm)	Och efter en stund så springer Berit och Kurt-Allan ut ur bastun och hoppar ner i det kalla vattnet. 
sprit (noun)	Trots dessa lagar, eller kanske på grund av dem, tycks svenskarna ha problem med spriten. 
dryg (adjective)	Sommarlovet slutar den första november och sen har man förstås en dryg pers, till jullovet börjar den elfte november. 
spritförbud (noun)	röstade man om spritförbud. 
dräkt (noun)	I Varje landskap finns det olika dräkter. 
kultur (noun)	I polykrona kulturer ser man tiden som en punkt. 
spränga (verb)	Eller om det finns en terrorist ombord som vill spränga planet. 
dröja (verb)	TELEFONISTEN: Var god och dröj ett ögonblick. 
dröm (noun)	Ytterst tacksam över att det hela bara var en dröm. 
kulturliv (noun)	och svenskt kulturliv och går igenom programmet gång på gång. 
dubbel (adjective)	Efter en ganska kort tid har summan vuxit till det dubbla p g a avgifter och räntor. 
språkhistoria (noun)	För en människa som inte fördjupat sig i språkhistoria är urnordiskan obegriplig i dag. 
duka (verb)	Han har lånat några extra stolar av grannarna och han har dukat. 
duktig (adjective)	skolan och han var också duktig i skolan, precis som pappa! 
dum (adjective)	Men fråga inte så dumt! 
språkkurs (noun)	Varför inte en språkkurs? 
kunglig (adjective)	De flesta tittar på Kungliga slottet, 
språklig (adjective)	Miraklen infinner sig, ganska ofta, och det är om dessa mirakel av språklig förståelse som jag vill tala. 
kurator (noun)	Annika Sundberg är kurator och livscoach i tidningen NÄRA DIG. 
dvs (adverb)	fick vi allmän rösträtt i Sverige, dvs. 
dygn (noun)	I norra Sverige skiner solen 24 timmar om dygnet under sommaren (ibland är det förstås mulet! 
dygnet runt (abm)	Ja, då kan du ta ut pengar dygnet runt. 
dyka (verb)	På senare år har vargar dykt upp då och då nära stora städer och samhällen. 
dyslektiker (noun)	Skoltiden var svår för han var dyslektiker. 
kustlinje (noun)	Kustlinjen är lång och det finns mer än 100000 sjöar. 
spänna fast (vbm)	Spänn fast säkerhetsbältet, är du snäll! 
kuva (verb)	kuvas av intet i världen. 
kvadrat (noun)	220 kvadrat, 1,2 miljoner bara. 
kvadratmeter (noun)	Rummet är på 18 kvadratmeter. 
därefter (adverb)	Därefter startar vårterminen, omkring den nionde- tionde januari (det är lite olika i olika kommuner). 
kvar (pl)	Jag sveper det sista av ölet i glaset och hänger kvar med blicken i hans ögon. 
däremot (adverb)	Däremot tycker folk inte att det är acceptabelt att bryta mot 30-kilometersgränser, säger Lars Åberg. 
spågumma (noun)	Kanske redan om några månader, fortsätter spågumman. 
spår (noun)	Det fanns flera spår för oss längdåkare: Silverspåret 10 km, Guldspåret 15 km och Världsmästarspåret 25 km. 
däri (adverb)	Den som gräver en grop åt andra, faller själv däri. 
stabil (adjective)	Det kostar bara 800 kronor, det är av lättmetall och mycket stabilt. 
kvinnlig (adjective)	Är 2000 skrevs 200 kvinnliga sökande in. 
då och då (abm)	De verkar sova lätt och öppnar ett öga då och då för att kolla vad som händer. 
kvist (noun)	Den äter mest löv och kvistar och den kan äta 50-60 kg per dygn. 
kvitta (verb)	Daniel: Det kvittar * att den är lite dyr. 
död (adjective)	LISA: Olas pappa är död. 
döda (verb)	Svenskarna slogs förtvivlat, och Karl själv dödade åtminstone tre fiender, men efter åtta timmar var striden slut. 
kvm (noun)	Boarea ca 74 kvm, 3 rum varav 2 sovrum. 
dödstrött (adjective)	Den siste, den dödströtte, är Straat. 
kvällssol (noun)	Balkongen är liten och ligger mot norr, så man har ingen kvällssol där. 
döpa (verb)	De fick en son som de döpte till Harald, Emil, Gustav (Emil efter morfar och Gustav efter farfar). 
dörr (noun)	Så frigjorde han sig från frågan och började gå mot dörren. 
kyckling (noun)	De har djur istället, t.ex. kor, svin, får, höns och kycklingar. 
kyl (noun)	Jag har precis köpt ny kyl, frys och mikro. 
kylskåp (noun)	Det finns en dusch, en toalett, en spis, ett kylskåp, en ugn och en diskbänk och flera skåp. 
e-postadress (noun)	Brian: Lisa, vad har du för e-postadress? 
kyrka (noun)	Nu har vi bara elva gotiska kyrkor kvar! 
effektiv (adjective)	Men jag tycker att jag är mer effektiv om jag gör flera saker på samma gång. 
stark (adjective)	Ibland kan ett av språken vara det känslomässigt starkare och framkalla kodväxling i laddade situationer. 
starköl (noun)	På lördagarna dricker han en halv flaska vin eller två starköl. 
start (noun)	Det var starten för det som sedan blev Telefon AB L M Ericsson. 
kyss (noun)	Kyssar från din Mimmi 
kyssa (verb)	Han bugar igen och kysser henne på handen. 
källa (noun)	Källa: USA Today 2002 
stat (noun)	Staten har också fått en ny uppgift i att få dem att stanna i landet. 
kämpa (verb)	På 1800-talet var människorna i Sverige mycket fattiga och de fick kämpa hårt för att få mat och kläder. 
kändis (noun)	Jag ska bli kändis, popsångare eller skådespelare, som Brad Pitt. 
känna igen (vbm)	Jag kände så väl igen honom. 
stativ (noun)	Då ska du ta det här stativet! 
känna sig (vbm)	Om dessa blev ostraffade kände han sig djupt kränkt ; om de belönades i onödan led hans rättskänsla. 
efteråt (adverb)	Teve sänder både från prisceremonin och festen efteråt, och i många länder följer man evenemanget med stort intresse. 
egen (adjective)	Han startade ett eget företag där och efter fem år flyttade familjen efter honom. 
statschef (noun)	Deras dotter Victoria är kronprinsessa och kommer att bli statschef efter sin far. 
statsman (noun)	Jag drömde om en jättesal, där statsmän satt på rad 
statsminister (noun)	Regeringen består av ungefär tjugo ministrar och chefen för regeringen kallas statsminister. 
ej (adverb)	Men ej skiljas från vännen min utan att fälla tårar. 
kär (adjective)	Får jag föreslå att vi skalar för vår kära värdinna? 
kärlek (noun)	och snart blir jag sjuk av all kärlek 
ekologisk (adjective)	Ekologisk, vegetarisk mat i lugn miljö. 
ekonom (noun)	Speciellt för ekonomer ser framtiden ljus ut. 
ekonomiavdelning (noun)	För 10 år sedan började jag på ekonomiavdelningen på ett stort företag. 
ekonomisk (adjective)	Socialdemokraterna (Sveriges socialdemokratiska arbetareparti) (s) vill verka för social och ekonomisk jämlikhet. 
kärnkraft (noun)	röstade vi om kärnkraften. 
kärring (noun)	När han inte är på gott humör, säger han tanten eller kärringen. 
el (noun)	Pr: 4 175000 el. 
elavdelning (noun)	Det finns många avdelningar på ett varuhus: en parfymavdelning, en sportavdelning, en elavdelning, en skoavdelning osv. 
eld (noun)	Man tänder eldar och sjunger vårvisor. 
stereo (noun)	Framför oss står tv, video och stereo av senaste modeller. 
kö (noun)	Det är lång kö till kassan och hon måste stå och vänta i nästan tio minuter. 
köksbord (noun)	De sitter vid köksbordet och diskuterar olika alternativ. 
elefant (noun)	Det är en elefant! 
sticka (noun)	Gumman, hon tog vita stickor av furu. 
elektriker (noun)	På gymnasiet kan man välja att studera till ett yrke, som t ex kock, elektriker, hårfrisörska eller något annat. 
elektronisk (adjective)	Han är mycket praktisk och kan reparera bilar och fixa elektroniska apparater. 
elev (noun)	En elev räcker upp handen. 
kön (noun)	diskrimineras på grund av kön, etnicitet, sexuell läggning eller funktionshinder. 
stig (noun)	De hittar en liten stig och följer den. 
stiga (verb)	Du ska få sen, när vi stigit opp från bordet. 
köp (noun)	Och så får du en film på köpet! 
eller hur (inm)	Och dessutom är hon ju ganska snygg, eller hur? 
stil (noun)	kafé i modern stil. 
köpare (noun)	Köparen var mycket nöjd, men i måndags meddelade en expert på Nationalmuseet att tavlan inte är av Zorn. 
emellertid (adverb)	Inne hos Millan är det emellertid ljust och varmt, för det står levande ljus överallt, och det doftar gott. 
emigrera (verb)	Sammanlagt emigrerade cirka en miljon svenskar till den amerikanska kontinenten. 
köra in (vbm)	De kör in där, parkerar och stiger ur. 
emot (preposition)	Mitt emot henne sitter Bodil, med handen på bordet. 
stipendium (noun)	Skriv övriga uppgifter som kan vara av intresse för arbetsgivaren, t ex körkort, stipendier, längre utlandsvistelser och ideellt arbete. 
stirra (verb)	Mina ögon är ganska fina, men ingen ser dem eftersom alla stirrar på min näsa. 
körkort (noun)	(Jag har inte någon bil och inte något körkort.) 
en aning (nnm)	Även om din näsa är en aning stor har du fina ögon. 
en annan (pnm)	Det hela slutar med att hon får barn med en annan. 
stjärna (noun)	Ät min get som heter Stjärna. 
stjärngosse (noun)	Lucia följs av tärnor med glitter i håret och stjärngossar med strutformade mössor. 
kött (noun)	När vi handlar i affären lockas vi av exotiska frukter, druvor från Sydafrika och kött från Brasilien. 
stjärngossemössa (noun)	Bara en av pojkarna har stjärngossemössa, men två stycken har i alla fall vita skjortor. 
köttbulle (noun)	En gång i veckan äter han köttbullar, korv, pannkaka och ärtsoppa och fisk av något slag. 
köttfärs (noun)	Jag ska be att få tre hekto köttfärs. 
köttfärspaj (noun)	Lisa tänker laga en köttfärspaj och Konsum har extrapris på köttfärs. 
en och en (pnm)	På morgonen äter familjen fil och flingor och Erik dricker en och en halv kopp kaffe med en sockerbit. 
labb (noun)	Vårt labb är jättestort, nästan för stort. 
stoj (noun)	barnens lek och stoj. 
lag (noun)	Den lagen avskaffades 1944. 
stolt (adjective)	Jag är både lycklig och stolt! 
stopp (noun)	Om det blir stopp måste du ringa till receptionen. 
stoppa (verb)	Kläderna hänger han in i garderoben och några andra prylar stoppar han in i skåpen. 
stoppa in (vbm)	Kläderna hänger han in i garderoben och några andra prylar stoppar han in i skåpen. 
lagom (adverb)	Var lagom duktig och tro inte att du är bättre än andra. 
lagra (verb)	Den senare typen kan lagras i kroppens fettlager. 
enligt (preposition)	Och den förmår inte rymma fler djupare och meningsfulla relationer än så, enligt Robin Dunbar. 
enorm (adjective)	Jag känner en enorm glädje över att den här perioden är över. 
stork (noun)	medan storkarna redde sitt bo. 
lakan (noun)	Byt lakan i sängen. 
ens (adverb)	Människor refererade till Jantelagen utan att ha läst boken eller ens veta vem Sandemose var. 
lamm (noun)	— Jag ska äta lamm med vitlök och rosmarin. 
storlek (noun)	Hon borde köpa skor i storlek 40 men om hon kröker tårna lite kan hon ha 39. 
ensamhushåll (noun)	46 procent av hushållen är ensamhushåll. 
landa (verb)	Efter en halvtimme ser hon Stockholm, och efter en kvart landar planet på Arlanda. 
ensamstående (adjective)	Det finns ju inte längre några moraliska eller religiösa strömningar i samhället som fördömer en ensamstående mor. 
stormarknad (noun)	Jag åker till stormarknaden och handlar. 
landgräns (noun)	Sverige har landgränser mot Norge och Finland men inte mot Danmark. 
enspråkig (adjective)	När du kommer till slutet av Rivstart kan du börja använda en enspråkig ordbok. 
storstad (noun)	Ska man bo i lägenhet eller i villa, på landet, i småstad, i storstad eller i förort? 
landsbygdsparti (noun)	Hette tidigare Bondeförbundet och är fortfarande ett landsbygdsparti med betoning på miljöfrågor. 
envis (adjective)	Han: Var inte så envis! 
landshövding (noun)	På flygplatsen står landshövdingen och tar emot dem. 
stortå (noun)	Då strök och masserade han stortårna på mig i ca tio minuter och tänk! 
storvinst (noun)	Gunnar vann storvinsten 3 miljoner kronor. 
erbjuda (verb)	Det finns även s.k. folkhögskolor, som erbjuder både studieplats och boende. 
erfarenhet (noun)	I stället vill jag tala om mina egna erfarenheter: hur man klarar sig på andra språk än sitt eget. 
landsväg (noun)	Jag har bott vid en landsväg i hela mitt liv 
strand (noun)	Ibland stannade vi och lyssnade på fåglarna, och ibland vilade vi på stranden. 
stress (noun)	Men jag misstänker att huvudvärken beror på stress. 
etablera (verb)	Det tar flera år att etablera sig. 
stressig (adjective)	Den här veckan har varit extra stressig för Fatoush. 
larm (noun)	Om du trycker fel kod eller har dörren öppen mer än en halv minut går larmet. 
etc (adverb)	Passera staket, gärdsgårdar, grindar etc, utom till annans tomt. 
etik (noun)	Etik och moral är viktiga frågor för partiet. 
lasagne (noun)	Patrik: Lasagnen är för salt. 
etnisk (adjective)	Arbetsplatsen passar alla arbetstagare oavsett kön, etnisk eller religiös tillhörighet, funktionshinder eller sexuell läggning. 
lat (adjective)	Hon är faktiskt ganska lat. 
stridsvagn (noun)	Men att försvara Sverige innebär mer än soldater och stridsvagnar. 
strumpa (noun)	Hennes strumpor är borta. 
etta (noun)	Här har vi ju en stor etta i ett gammalt hus nära centrum. 
laxrosa (adjective)	Väggarna i vardagsrummet är laxrosa. 
le (verb)	Det var Gary själv som stod där och log sitt bredaste leende mot dem. 
evenemang (noun)	Teve sänder både från prisceremonin och festen efteråt, och i många länder följer man evenemanget med stort intresse. 
ledsen (adjective)	Ledsen hör du du, säger han, men jag blir sen ikväll. 
sträck (noun)	jag sett vildgässens sträck under kvällande sky. 
eventuell (adjective)	På kvällen halvklart, eventuellt sol, 6- 9 grader. 
ex (noun)	Det är också vanligt med sammansättningar, t ex Almgren, Lindgren, Ekstam, Ekblad, Asklöv, Lindkvist och Hägglöf. 
exakt (adjective)	Man har gjort en exakt kopia av museet och besökaren rör sig runt som i ett dataspel. 
sträckläsa (verb)	Jag fick En svensklärares dagbok i julklapp och den sträckläste jag. 
lejon (noun)	Det är ett lejon. 
leka (verb)	Ibland kunde han gå ut och leka också. 
exempel (noun)	En möjlighet att fortsätta i annan form fanns förstås, inom Stockholm till exempel gick fem postturer om dagen. 
leksak (noun)	Mycket av min lek gick ut på att bygga leksaker och prova nya konstruktioner. 
strömming (noun)	Sillen är en fisk som lever på ost- och västkusten ; På ostkusten heter den strömming. 
expert (noun)	Köparen var mycket nöjd, men i måndags meddelade en expert på Nationalmuseet att tavlan inte är av Zorn. 
student (noun)	När Adam började var han fattig student. 
leta (verb)	Jag letar igenom minnet efter sammanhang där den här killen skulle kunna passa in, men ingenstans dyker han upp. 
studenthem (noun)	På Armégatan i Solna ligger ett studenthem. 
export (noun)	En del av järnet använder man inom svensk industri, men en stor del går på export. 
studentmössa (noun)	Unga och gamla studenter sätter på sig vita studentmössor, barn kastar smällare och ibland har man fyrverkeri. 
studentrum (noun)	Men det är inte så mycket, för man måste betala studentrum, mat, böcker och allt annat. 
exportindustri (noun)	Man har stor exportindustri, men även annan export, musik till exempel. 
studenttidning (noun)	Studenttidningen har intervjuat några utbytesstudenter i Sverige. 
leve (noun)	Ett fyrfaldigt leve för födelsedagsbarnet! 
studie (noun)	Det tycker många i en brittisk studie. 
extra (adjective)	En extra växel skulle lösa problemet. 
leverans (noun)	Det är problem med en leverans. 
extrajobb (noun)	Nu vill hon ha ett extrajobb, för hon behöver pengar. 
levnad (noun)	och alla min levnads dagar. 
studiecirkel (noun)	Ca två miljoner personer studerar i studiecirklar/år. 
extrapris (noun)	Lisa tänker laga en köttfärspaj och Konsum har extrapris på köttfärs. 
studielån (noun)	Hassan tjänar bra men Linda har studielån. 
libanesisk (adjective)	Jag älskar libanesisk mat. 
liberal (noun)	folkpartiet liberalerna (fp) eller folkpartiet 
studieplats (noun)	Det finns även s.k. folkhögskolor, som erbjuder både studieplats och boende. 
fack (noun)	Jag blev medlem i facket där, och jag var också med i nykterhetsrörelsen. 
fackförening (noun)	Arbetarna började organisera sig i fackföreningar och Socialdemokratiska arbetarepartiet grundades år 1889. 
lifta (verb)	Efter en dag på Kebnebuse fjällstation gick vi till Nikkaluokta och liftade till Kiruna. 
stund (noun)	Han måste w ha tittat en stund för nu vinkar han. 
stuva (verb)	runt gård och stuva. 
stygn (noun)	Mamma körde mig till sjukhuset och de har sytt tre stygn. 
liksom (adverb)	Jag har liksom inte hunnit, svarade Emil. 
falla (verb)	Men den som föll i strid kunde få komma till Oden på hans gård Valhall. 
städa undan (vbm)	Ibland får jag förstås gäster, men då brukar jag försöka städa undan lite grand ... 
ställa (verb)	Den ställer de flesta bilister upp på både i teorin och praktiken. 
ställa in (vbm)	Det står ju faktiskt här på skylten: Ställ in disken i diskmaskinen. 
ställa sig (vbm)	Ställ dig vid det där skåpet så ska jag ta några bilder .... Sätt dig nu här vid fönstret. 
falsk (adjective)	Till exempel är många av viruslarmen, när det gäller datorer och mobiltelefoner, falska. 
lingon (noun)	Helena: Men varför finns det inga lingon? 
lingonsylt (noun)	Ursäkta, har ni lingonsylt? 
ställa upp (vbm)	Annars måste vi bo i skolan som de andra eller kanske hos släktingar, om de ställer upp. 
ställe (noun)	I stället vill jag tala om mina egna erfarenheter: hur man klarar sig på andra språk än sitt eget. 
linje (noun)	Vilken linje ska man följa? 
stämma (verb)	Kom jag ut ur en butik tomhänt var det någonting som inte stämde. 
linjereparatör (noun)	Det kan vara yrken som flygplatsbrandman, linjereparatör eller räddningsman. 
stämning (noun)	Det är mycket folk, bra musik och hög stämning. 
lite grann (pnm)	Ja, lite grann, men det är inte så farligt. 
liter (noun)	Mor: Fyra liter kanske. 
litteraturvetenskap (noun)	Hon studerar litteraturvetenskap på universitetet. 
fantasi (noun)	Nu kan man inte ta muttrar med skruvmejsel, men faderns fantasi var i rörelse och han lät lura sig. 
stånd (noun)	Bland karuseller, berg- och-dalbanor, stånd med pilkastning, lotterier och varmkorv sitter en spågumma i ett tält. 
far (noun)	Vid bordet rådde dödstystnad bland barnen och fadern talade mycket lite. 
livscoach (noun)	Annika Sundberg är kurator och livscoach i tidningen NÄRA DIG. 
stödja (verb)	Pengar till studierna och sitt uppehälle fick han av rika personer som ville stödja den begåvade unge mannen. 
farfarsfar (noun)	För precis hundra år sedan då bodde min farfarsfar och min farfarsmor i Hallstavik. 
farfarsmor (noun)	För precis hundra år sedan då bodde min farfarsfar och min farfarsmor i Hallstavik. 
farlig (adjective)	Han är inte farlig 
livsmedelsavdelning (noun)	Dessutom finns det ofta en stor livsmedelsavdelning. 
stövel (noun)	Gå till skomakaren och hämta mina svarta stövlar. 
substantiv (noun)	Tänk på vilken form substantivet måste ha! 
livsverk (noun)	Hans livsverk är ett stort möbelvaruhus, IKEA. 
sucka (verb)	Ja, mamma suckar han. 
ljud (noun)	Inte ett ljud hörs utom en ugglas hoande i fjärran. 
fast (conjunction)	Fast det är nog mamma och pappa som investerat. 
fast (adjective)	Jag har inget fast jobb än, så jag har inte så mycket pengar. 
ljuga (verb)	Jag ljuger ganska mycket! 
summa (noun)	Kanske kommer du att vinna en summa pengar. 
fastighet (noun)	I fastigheten finns Tvättstuga, Torkrum, Cykelförråd och Förråd. 
ljus (noun)	stiger med tända ljus: 
ljusblå (adjective)	Hennes blus är också vit, men västen är blå med ljusblåa blommor. 
fattig (adjective)	Alfred föddes 1833 i ett fattigt hem i Stockholm. 
supportavdelning (noun)	Hej, jag heter Leif Gustavsson och ringer från supportavdelningen. 
sur (adjective)	Berit är lite sur. 
sura (verb)	När vi är borta länge, sitter han och surar och är alldeles tyst. 
favoritblomma (noun)	Fråga: Vilken är din favoritblomma? 
favoritcitat (noun)	Fråga: Vad är ditt favoritcitat? 
favoritdjur (noun)	Fråga: Vilket är ditt favoritdjur? 
favoritfärg (noun)	Fråga: Vilken är din favoritfärg? 
surströmming (noun)	Serverar kräftor och surströmming i augusti. 
favoritförfattare (noun)	Fråga: Vem är din favoritförfattare? 
lokal (noun)	Han vill renovera lokalen och med Jonas Åberg. 
sushi (noun)	Hon hade mycket att göra på jobbet sedan, så hon köpte sushi som hon åt på kontoret. 
favoritmusiker (noun)	Fråga: Vem är din favoritmusiker? 
favoritnamn (noun)	Fråga: Vilket är ditt favoritnamn? 
favoritord (noun)	Fråga: Vilket är ditt favoritord? 
svag (adjective)	Vädret är soligt med svag vind, cirka 10 minusgrader och en meter snö. 
svamp (noun)	Far: Jodå, men jag har plockat en massa svamp också. 
feber (noun)	DAVID: Har du feber? 
feberfri (adjective)	Nu måste du gå hem och vila tills du är feberfri. 
febertermometer (noun)	Han hittar sin/febertermometer i badrumsskåpet och ' tar tempen *. 
svar (noun)	Svaret på den första frågan är nej medan den andra får ett klart ja. 
lott (noun)	Hon tänker pröva lyckan och köpa en lott i Chokladlotteriet. 
februari (noun)	Mellan 1 november och 28 februari hissar man flaggan klockan nio och halar den senast klockan tre. 
lotteri (noun)	Bland karuseller, berg- och-dalbanor, stånd med pilkastning, lotterier och varmkorv sitter en spågumma i ett tält. 
lotto (noun)	Därför spelar han på lotto och tips. 
lov (noun)	Sedan fick vi lov att backa i fem kilometer, tills vi kom till en verkstad. 
lova (verb)	och tyst lovar man att sluta röka eller att börja banta eller någonting annat. 
svart (adjective)	Skorna är också svarta, och runt knäna har han röda tofsar. 
svartsjuk (adjective)	Han blev svartsjuk, och de började gräla. 
lucia (noun)	Vid lucia börjar många känna sig stressade, för det är mycket som ska ordnas till julafton den 24 december. 
lucialinne (noun)	Flickorna tar på sig lucialinnen och sätter glitter i håret. 
femtio (numeral)	Konsum ligger femtio meter från ICA och det tar bara ett par minuter att gå dit. 
luciasång (noun)	Luciasångens melodi är tagen från en italiensk visa. 
luciatåg (noun)	Vaktmästaren släcker ljuset och efter några minuter kommer luciatåget. 
luft (noun)	Luften blir till is i näsan, när man andas. 
lugn (adjective)	Och det är ett mycket lugnt område. 
lugn (noun)	Jag övar mycket hemma, och då behöver jag lugn och ro. 
svensklärare (noun)	Jag fick En svensklärares dagbok i julklapp och den sträckläste jag. 
lugna ner sig (vbm)	De fnittrar nervöst i hissen, men väl uppe lugnar de ner sig. 
lugna sig (vbm)	De fnittrar nervöst i hissen, men väl uppe lugnar de ner sig. 
lukt (noun)	Solen skiner, det blåser och de känner lukten av hav. 
lukta (verb)	Linda: Ja, nu känner jag att det är någonting som luktar gott. 
festmat (noun)	Lax är festmat för många svenskar. 
lump (noun)	Ville jag överhuvudtaget göra lumpen? 
fet (adjective)	Fet mat gillar jag inte. 
lunga (noun)	Jag vill lyssna på lungorna också. 
svin (noun)	De har djur istället, t.ex. kor, svin, får, höns och kycklingar. 
lur (noun)	För en halvtimme sedan ringde Linda och ropade i luren: 
figur (noun)	Är hon en figur i en bok? 
svägerska (noun)	Drottning Silvia har alltså fyra svägerskor, men varken svärfar eller svärmor. 
fika (noun)	En fika eller en öl? 
fika (verb)	fikade några gånger före jul, och då såg det helt annorlunda ut. 
lussekatt (noun)	I köket står några trötta ungdomar och brygger kaffe och värmer upp lussekatter i ugnen. 
sväng (noun)	Dessförinnan hade maken bara gjort små svängar runt kvarteren. 
fikapaus (noun)	På Karolinska Institutet i Stockholm hör man nästan bara engelska på fikapauserna. 
svära (verb)	Hon måste vara snäll och hänsynsfull och hon får inte svära. 
lutfisk (noun)	och lutfisk från julbordet den 24 december. 
fil (noun)	Det tar minst tre år och för att få en fil. 
svärfar (noun)	Drottning Silvia har alltså fyra svägerskor, men varken svärfar eller svärmor. 
lycka (noun)	din lycka är min 
svärmor (noun)	Drottning Silvia har alltså fyra svägerskor, men varken svärfar eller svärmor. 
lycklig (adjective)	Jag är både lycklig och stolt! 
lysa (verb)	), men på vintern är det mörkt och kallt, fast snön lyser upp landskapet. 
filt (noun)	Det är mysigt i filten. 
sydlig (adjective)	Av dem bor nästan 90 % i de sydligare delarna av landet. 
filé (noun)	Det brukar räcka att dela varje filé på mitten. 
finansiera (verb)	De flesta finansierar sina studier med studielån, pengar som staten lånar ut. 
sydspets (noun)	Stockholm ligger på samma breddgrad som Grönlands sydspets och Alaska och Sibirien. 
finger (noun)	Sätter den på fingret? 
lägenhetsvisning (noun)	Rolf och Annika är på väg till en lägenhetsvisning. 
symbol (noun)	Därför kunde man se symbolen på vissa skrivmaskiner. 
lägga (verb)	I Indien lägger man tonvikt på första stavelsen i event. 
lägga av (vbm)	EMIL: Lägg av nu! 
syn (noun)	En riktigare syn, säger Jan Garnert, det är ju trots allt människor som pratar i telefoner. 
lägga in (vbm)	Sillen äter vi ofta inlagd i ättika (svensk vinäger), salt och socker. 
fiol (noun)	Fiol och nyckelharpa ... 
fira (verb)	Hur ska du fira din födelsedag, då? 
firma (noun)	Ellen arbetar på posten och Jonas är målare och har egen firma. 
lägga upp (vbm)	Jag satt i en soffa och lade upp fötterna i knät på honom. 
fiskdisk (noun)	Expediten: Ja, jag kan hämta från fiskdisken. 
fisklasagne (noun)	Servitören: Varsågoda, en stekt lax med pommes frites och dillsås, en biff med romsås och ris och en fisklasagne. 
läkemedelsföretag (noun)	De flyttade till Sverige när Fatoush fick ett toppjobb på ett läkemedelsföretag i Göteborg. 
lämna (verb)	Men många italienare hävdar att kungen stal den och vill att Frankrike ska lämna tillbaka den till Italien. 
lämna in (vbm)	Han har inte diskat kastrullerna och han har glömt att lämna in tipset. 
fjäll (noun)	röda stugor, djupa skogar, blåa sjöar, höga fjäll ... 
lämna tillbaka (vbm)	Efter några dagar lämnade Eva tillbaka ringen. 
lämna åter (vbm)	och aldrig jag lämnar det åter. 
syssla (verb)	Jag promenerar eller sysslar med mina frimärken. 
sysslolös (adjective)	Under tiden var inte mor sysslolös. 
fjällstation (noun)	Efter en dag på Kebnebuse fjällstation gick vi till Nikkaluokta och liftade till Kiruna. 
län (noun)	I Stockholms län är 26 procent av alla 20-27-åringar mambo. 
länge sedan (abm)	Birgitta: Ett par gånger, men det var rätt länge sedan nu. 
fjät (noun)	Natten går tunga fjät, 
sädesslag (noun)	Rågen är ett sädesslag som kan växa i kallt klimat. 
flagga (noun)	Mellan 1 mars och 31 oktober hissar man flaggan klockan åtta och halar den vid solens nedgång. 
längesen (adverb)	Men den tiden var för längesen förbi. 
längs (preposition)	När vädret tillåter har vi promenader längs ån. 
säker (adjective)	Nej, det är inte alls säkert. 
säkerhetsbälte (noun)	Spänn fast säkerhetsbältet, är du snäll! 
läpp (noun)	Nobelpriset och Sverige är på allas läppar! 
lära (verb)	Men plötsligt började hon tala om att också hon ville lära sig grekiska. 
lära om (vbm)	Du glömmer 80 % av det du lärt dig inom 24 timmar om du inte repeterar. 
lära sig (vbm)	Men plötsligt började hon tala om att också hon ville lära sig grekiska. 
sällskap (noun)	Man tackar för maten, man tackar för sällskapet, man tackar för lånet, man tackar för uppmärksamheten. 
sända (verb)	Teve sänder både från prisceremonin och festen efteråt, och i många länder följer man evenemanget med stort intresse. 
lärobok (noun)	Just nu sitter du (eller ligger eller står) och läser en text i din lärobok. 
sänglampa (noun)	De har också en soffa, ett bord, fyra stolar och två sängar, två garderober, två sänglampor och en taklampa. 
flinga (noun)	På morgonen äter familjen fil och flingor och Erik dricker en och en halv kopp kaffe med en sockerbit. 
läsa in (vbm)	Det finns många böcker som är inlästa på band. 
flitig (adjective)	Hon är duktig, men inte särskilt flitig. 
särbo (noun)	Sedan kan man bo ensam eller vara sambo, särbo, iblandbo eller mambo. 
säsong (noun)	I dag har hotellet ca 15 000 gästnätter per säsong. 
flod (noun)	Laxen är en stor fisk som lever både i floder och hav. 
fluga (noun)	Hon var så snäll att hon aldrig skulle kunna göra en fluga förnär. 
läsning (noun)	Han åt en smörgås till mellanmål, och sedan gjorde han läxorna läsning, skrivning eller en psalmvers. 
flyga (verb)	då ärat ditt namn flög över jorden. 
sätta fingret (vbm)	Sätter den på fingret? 
sätta in (vbm)	Sätt in nya ord i ett sammanhang. 
lätt (adjective)	Det är lätt att uttrycka sig fel. 
sätta på (vbm)	Daniel stiger upp, sätter på * 
sätta på sig (vbm)	Unga och gamla studenter sätter på sig vita studentmössor, barn kastar smällare och ibland har man fyrverkeri. 
sätta ut (vbm)	Värnar om samhällets utsatta grupper. 
flygplan (noun)	Ann sitter i flygplanet och bläddrar i några vackra broschyrer om Sverige, svensk kultur 
flygplats (noun)	På flygplatsen står landshövdingen och tar emot dem. 
lättmetall (noun)	Det kostar bara 800 kronor, det är av lättmetall och mycket stabilt. 
flygplatsbrandman (noun)	Det kan vara yrken som flygplatsbrandman, linjereparatör eller räddningsman. 
så där ja (inm)	* Så där ja *. 
så klart (abm)	Anna: På engelska, så klart! 
flygvapen (noun)	Värnplikten gör man inom det militära försvaret, inom armén, marinen eller flygvapnet. 
flykting (noun)	Det undrade Ahmed och hans bror Muhammed som kom till Sverige som flyktingar. 
läxa (noun)	Ibland vill hon inte städa eller göra läxorna. 
flytta hit (vbm)	Sedan flyttade jag hit. 
låg (adjective)	Kroppen har låg aktivitet och musklerna är avslappnade. 
sågverk (noun)	Han hade fem kilometer till sågverket och måste gå hela vägen. 
flytta ut (vbm)	De vill flytta ut på landet och leva ett lugnare liv med sina barn. 
sång (noun)	Men då måste vi sjunga en sång! 
lån (noun)	Man tackar för maten, man tackar för sällskapet, man tackar för lånet, man tackar för uppmärksamheten. 
fläsk (noun)	Från hönsen får vi ägg, från fåren ull och kött, från svinen fläsk och från korna kött och mjölk. 
låna ut (vbm)	De flesta finansierar sina studier med studielån, pengar som staten lånar ut. 
sångerska (noun)	På kvällarna sjöng hon i en kör och drömde om att bli sångerska. 
flöjt (noun)	Tält, sovsäckar, campingkök och vara flöjter hade vi med oss. 
sås (noun)	Sedan äter de mamma Brittas goda slottsstek med kokt potatis, lingon, gurka och brun sås. 
fnittra (verb)	De fnittrar nervöst i hissen, men väl uppe lugnar de ner sig. 
långhårig (adjective)	Plötsligt står en ung man där, långhårig, orakad, klädd i en smutsig, brun kostym. 
långsam (adjective)	hon var snabbast på 60 meter jag var långsammast 
folkdansgrupp (noun)	Folkdansgrupper och spelmän använder dem ofta. 
söka (verb)	Det verkar som om den yngre generationen söker ett uttryck för respekt, hövlighet eller bara för att markera distans. 
folkdräkt (noun)	Än idag finns det folkdräkter i Sverige. 
långt borta (abm)	Långt borta ser hon Kebnekaise. 
långt ifrån (abm)	Man är aldrig speciellt långt ifrån vatten. 
sömmerska (noun)	Mamma var sömmerska och städade också ibland. 
folkhögskola (noun)	Det finns även s.k. folkhögskolor, som erbjuder både studieplats och boende. 
folkmusik (noun)	Kim: Nej, nej, jag studerar folkmusik. 
folkomröstning (noun)	var det folkomröstning om tilläggspension. 
sömnig (adjective)	Jag blev alldeles lugn och sömnig, och huvudvärken gick över! 
folkparti (noun)	folkpartiet liberalerna (fp) eller folkpartiet 
låta (verb)	Jag skakar på huvudet och låter så förnärmad jag kan. 
folkskola (noun)	Efter sex år i folkskolan (nu säger man grundskolan) började jag i realskolan (idag heter det högstadiet). 
söndagkväll (noun)	Det är söndagkväll, och Daniels mamma och pappa sitter i vardagsrummet och pratar om festen i går. 
löjlig (adjective)	Jag tycker faktiskt att det är löjligt med könskvotering. 
söndagsmiddag (noun)	Där brukar de ofta äta en riktigt traditionell söndagsmiddag mitt på dagen. 
lök (noun)	Där köper hon också glass till efterrätt och lök till pajen. 
fordonsprogram (noun)	Det finns praktiska program som till exempel fordonsprogrammet och teoretiska program som naturvetenskapsprogrammet. 
form (noun)	De andra färdades med båt som även fraktade mycket rikedom i form av konstverk och böcker. 
löpande band (nnm)	när du står vid löpande bandet! 
ta av (vbm)	När Klara kommer till dagis, måste hon ta av stövlar, sockor, vantar, jacka, byxor, halsduk och mössa. 
ta av sig (vbm)	Väntrummet är ganska fullt, så Daniel tar av sig jackan och sätter sig ner. 
lördagskorv (noun)	Skulle jag kunna få ett hekto lördagskorv också? 
ta bort (vbm)	ska du ta bort pappret på blommorna innan du ger dem till värdinnan. 
ta det lugnt (vbm)	Inte sån där hetsig gympa som de har på gymmet i centrum, utan här tar vi det lugnt. 
ta emot (vbm)	På flygplatsen står landshövdingen och tar emot dem. 
fors (noun)	En gång, när vi skulle gå över en fors, föll jag i vattnet! 
löv (noun)	De gräver och planterar och krattar löv och väntar på sommaren. 
ta fram (vbm)	Hon tar fram flygplanets tidning och tittar på en karta. 
ta hand (vbm)	Men imorgon kommer jag hem tidigt och tar hand om Lillan! 
forskarutbildning (noun)	Efter examen kan man söka till forskarutbildning för att ta doktorsexamen. 
mage (noun)	Klara: Då ..., då har du en bebis i magen, Linda. 
ta på sig (vbm)	Flickorna tar på sig lucialinnen och sätter glitter i håret. 
magister (noun)	Ursäkta, magistern, men vi har inte dig. 
ta sig (vbm)	Det är klart att man tar sig fram efter eget huvud då. 
fortsättning (noun)	Nya Mål 2 är en fortsättning på Nya Mål 1. 
maj (noun)	Midsommar, Lucia, valborgsmässoafton, första maj, kungen, drottningen, riksdagen, regeringen, demokrati, Ingmar Bergman, Björn Borg, Greta Garbo, Birgit Nilsson. 
majbrasa (noun)	Tänder majbrasa på valborgsmässoafton. 
majestät (noun)	Han satte sig i taxin och upprepade: Ers majestät! 
fot (noun)	Jag satt i en soffa och lade upp fötterna i knät på honom. 
makaroner (noun)	Han får makaroner och korv som Hassan har delat i små, små bitar. 
makt (noun)	Allt fler människor världen runt upptäcker vilken makt och vilka överraskningar som kan ligga i gester och kroppsspråk. 
ta upp (vbm)	Förresten vad gör du på lördag ?Är du upptagen då? 
fotbollsproffs (noun)	Jag vet precis, fotbollsproffs! 
ta vara (vbm)	Nej, nu ska jag ta det lugnt och vara med mina barnbarn, säger Gunnar. 
malm (noun)	I Norrland finns stora naturresurser: skog, vattenkraft och malm. 
mambo (noun)	I Stockholms län är 26 procent av alla 20-27-åringar mambo. 
tablett (noun)	Tycker du att tabletterna hjälper? 
mammaledig (adjective)	Först var Sofia mammaledig, och sedan var Tobias pappaledig. 
tacka (verb)	Ja men, det är ju när nån tackar dig, och sen tackar du också för att dom har tackat. 
tacka nej (vbm)	Knut: Du kunde inte tacka nej? 
fotoväska (noun)	Har ni det ?Är det där en fotoväska? 
fotsula (noun)	Fotsulorna vänder man aldrig mot en annan person i Indien. 
frack (noun)	Du med lång vit klänning och jag med frack. 
tag (noun)	Jag har inte varit där på ett tag, men jag skulle gärna vilja åka dit snart. 
fram (pl)	Det är klart att man tar sig fram efter eget huvud då. 
framföra (verb)	Kan du framföra det, är du snäll! 
tal (noun)	Själv vill hon eller han befria sitt tal från det mesta som kan lukta lokalt och lantligt. 
talang (noun)	Fråga: Vilken talang skulle du vilja ha? 
framme (pl)	Efter fyra dagar var vi framme i ett litet samhälle, som heter Blankafors. 
framme (adverb)	Och sväng till vänster där framme! 
marginal (noun)	Den som har små marginaler bör kanske göra det, säger Linda Lindgren på Stockholmsbanken. 
marin (noun)	Värnplikten gör man inom det militära försvaret, inom armén, marinen eller flygvapnet. 
mark (noun)	plantera ' han på marken 
framtand (noun)	Det är ett stort hål här i framtanden. 
markering (noun)	Du häller i här upp till den här röda markeringen. 
framtid (noun)	Trots detta dystra faktum finns det ljusglimtar som inger hopp inför framtiden. 
tallrik (noun)	Till frukost äter du en tallrik gröt eller en tallrik filmjölk med müsli. 
framtidsanalytiker (noun)	Kristoffer är framtidsanalytiker på en konsultfirma. 
marmelad (noun)	I Sverige äter man marmelad till köttbullar. 
framåt (adverb)	Man får tänka framåt, planera i olika steg. 
mars (noun)	Mellan 1 mars och 31 oktober hissar man flaggan klockan åtta och halar den vid solens nedgång. 
tandklinik (noun)	Kontakta Siv Olofsson på Tandkliniken. 
maskin (noun)	Häng tvätten som ligger i maskinen. 
fred (noun)	jag drömde det var fred på jord 
maskros (noun)	Den vanligaste blomman är maskrosen. 
massera (verb)	Då strök och masserade han stortårna på mig i ca tio minuter och tänk! 
fredspris (noun)	Ett femte pris, fredspriset, delas ut i Oslo. 
massör (noun)	Jag har en vän, som heter Mats, som går och utbildar sig till massör. 
mataffär (noun)	Vi köper jordgubbar på torget och i mataffären, eller åker och plockar själva på självplock. 
matbord (noun)	En dag när Hassan kommer hem tidigt från jobbet, hittar han ett meddelande från Linda på matbordet. 
matdag (noun)	Men hur ser en bra matdag ut? 
matematik (noun)	På olika program läser man lite olika ämnen, men alla läser svenska, engelska och matematik. 
matematisk (adjective)	Men nu står de små matematiska hjärtana tillsammans med ett dsm. 
tavla (noun)	Innerst inne trodde hon nog inte att någon tavla skulle hitta hem till henne i mellersta Norrland. 
matlagning (noun)	Hon hjälpte mig med matlagning och tvättade mina kläder. 
taxiparkering (noun)	Han kör in på en taxiparkering och hans kollega Gunilla kör in efter honom. 
matlagningskurs (noun)	Gunnar går på matlagningskurs. 
maträtt (noun)	Fråga: Vilken maträtt tycker du bäst om? 
matsked (noun)	2 matskedar margarin eller smör 
matsäck (noun)	Då åt barnen matsäcken som de hade med sig hemifrån. 
frisk (adjective)	C: Jag ska se ... Norrland, Svealand ... Götaland ... här har vi det: Måttlig till frisk vind. 
friskola (noun)	Det finns kommunala skolor och friskolor. 
med andra ord (abm)	Med andra ord: I Sverige har alla möjlighet att studera och det är aldrig för sent att börja! 
fritidshus (noun)	Många campar i tält eller husvagn, har båtar, fritidshus eller kolonilotter. 
teknik (noun)	Hon har inte förstått tekniken. 
teknisk (adjective)	Jag läste naturvetenskapligt program på gymnasiet och sedan började jag på Chalmers tekniska högskola i Göteborg. 
frukostbord (noun)	Jesper och Camilla sitter och läser tidningen vid frukostbordet. 
telefonist (noun)	TELEFONISTEN: Han är upptagen i telefon. 
frukostmöte (noun)	De hade ett frukostmöte på hotell Aveny i stan. 
telefonkatalog (noun)	i telefonkatalogen och ringer till en läkare. 
frukt (noun)	Vi odlar frukt och grönsaker också i Sverige, men det räcker naturligtvis inte. 
telefonkonferens (noun)	Fatoushs chef sa att de måste ha en mycket viktig telefonkonferens. 
meddela (verb)	I går meddelade Riksbanken att man höjer räntan med 1 procent. 
meddelande (noun)	Hassan läser meddelandet och suckar. 
fruktjuice (noun)	Mänga olika goda fruktjuicer att dricka ekologiska förstas. 
fruktträd (noun)	Thomas: Titta på det här huset, 114 kvadratmeter, tre sovrum, nyrenoverat kök och stor trädgård med fruktträd. 
medellivslängd (noun)	Medellivslängden var 47 år. 
telefonsvarare (noun)	LINDA: Har du varit hos Lisa och hjälpt henne med telefonsvararen? 
frysa (verb)	Fjädrarna bevarar kroppsvärmen, men om det blåser, eller om de blir våta, kan de börja frysa. 
medelsvensson (noun)	Medelsvensson heter Erik Johansson och är en typisk svensk. 
frysvara (noun)	De finns mellan godiset och frysvarorna. 
telegrafutrustning (noun)	1876 flyttade Lars Magnus till Stockholm och tog arbete på en firma som tillverkade telegrafutrustning. 
medelålder (noun)	Medelåldern på universitetet är alltså ganska högjämfört med andra länder. 
fräsch (adjective)	Köket är alldeles nytt och fräscht, men Annika tycker inte om färgerna där heller. 
temp (noun)	Han hittar sin/febertermometer i badrumsskåpet och ' tar tempen *. 
fråga (noun)	Det är egentligen mest en fråga om tid och om att vilja. 
fråga sig (vbm)	Gösta: Ja ... eh ... Greta ringde mig och ville gå på bio och hon frågade mig ... 
temperatur (noun)	Hur mäter vi temperatur? 
tennisfinal (noun)	Jag har biljetter till tennisfinalen i Wimbledon. 
medlem (noun)	Jag blev medlem i facket där, och jag var också med i nykterhetsrörelsen. 
fröken (noun)	Vi hade tur, som fick fröken Roslander! 
medlemskap (noun)	röstade vi om medlemskap i den Europeiska Unionen. 
ful (adjective)	Hon var vackrast i klassen jag var fulast 
full (adjective)	och full av äventyr och full av lärdomar. 
teoretisk (adjective)	Vill man förbereda sig för att studera vidare på universitetet efter gymnasiet väljer man en mer teoretisk utbildning. 
teorilektion (noun)	Jag tog min första teorilektion i går faktiskt. 
termin (noun)	I skolan har man två terminer: höst- och vårterminen. 
mejerivara (noun)	Där finns det frukt, grönsaker, drycker, kött, konserver, bröd, mejerivaror etc. 
fullständig (adjective)	Det fullständiga resultatet återkommer vi till i morgondagens upplaga. 
mejla (verb)	John sitter på ett internetkafé och mejlar hem till Kanada. 
mekanisk (adjective)	I stället sökte jag arbete på en mekanisk verkstad som tillverkade motorer. 
fundera (verb)	Jag funderar ett ögonblick och bestämmer mig för att det bara finns en sak att säga. 
fungera (verb)	Inget råd tycktes dock fungera på honom. 
mellanblond (adjective)	Han är 179 cm (centimeter) lång, mellanblond och ganska tystlåten. 
tesked (noun)	1 1/2 tesked salt 
testa (verb)	Vill du testa dina smaklökar? 
testamente (noun)	I Gamla testamentet kan man läsa liknelsen om Babels torn. 
mellandag (noun)	Det kunde hända att vi under någon av mellandagarna blev bortbjudna på kaffe till en granne. 
mellanmål (noun)	Han åt en smörgås till mellanmål, och sedan gjorde han läxorna läsning, skrivning eller en psalmvers. 
mellanstor (adjective)	1 mellanstor, finhackad, gul lök 
melon (noun)	— Ar melonerna goda? 
fylla (verb)	Innan hon fyllde tolv år kunde hon konversera på grekiska, latin, franska och tyska. 
memoarbok (noun)	Hon vill skriva en memoarbok. 
text (noun)	Dina ögon ser texten och din hjärna tolkar innehållet och du tänker: Vilken konstig text! 
textbok (noun)	Lyssna mycket på textbokens cd. 
fyrfaldig (adjective)	Ett fyrfaldigt leve för födelsedagsbarnet! 
mera (adverb)	Om du vill läsa mera kan du titta på www.lumpen.pliktverket.se 
fyrkantig (adjective)	Vi har ju fått kabelteve och våra barn tittade tills ögonen blev fyrkantiga under julen. 
fyrverkeri (noun)	Unga och gamla studenter sätter på sig vita studentmössor, barn kastar smällare och ibland har man fyrverkeri. 
messa (verb)	* messa = skicka direktmeddelande till varandra på nätet eller i mobilen 
fysisk (adjective)	För att det är en fysisk och psykisk utmaning, men inte för att bevisa något för andra. 
fälla (verb)	Vem kan skiljas från vännen sin utan att fälla tårar? 
färdig (adjective)	Vi måste ha rapporten färdig idag. 
mexikansk (adjective)	Specialitet: chiliöl och chilitequila Vår mexikanska rockgrupp spelarl 
tidskrift (noun)	Där kan vem som helst låna böcker och tidskrifter gratis. 
middagsgäst (noun)	Klockan halv sju skulle deras middagsgäster komma. 
färg (noun)	Jaha, ... många färger. 
tidtabell (noun)	Hon hittar en tidtabell. 
midnattsgolf (noun)	I juni var jag uppe i Kiruna och spelade midnattsgolf. 
midsommar (noun)	Midsommar, Lucia, valborgsmässoafton, första maj, kungen, drottningen, riksdagen, regeringen, demokrati, Ingmar Bergman, Björn Borg, Greta Garbo, Birgit Nilsson. 
midsommarafton (noun)	Dansar kring midsommarstången och äter sill 4 och nypotatis och jordgubbar på midsommarafton. 
färja (noun)	Färjan tar bara en kort stund. 
färjeläge (noun)	Till höger efter färjeläget och sedan till vänster in på en liten grusväg. 
färskpotatis (noun)	På sommaren finns färskpotatis som är extra god. 
midsommarstång (noun)	Dansar kring midsommarstången och äter sill 4 och nypotatis och jordgubbar på midsommarafton. 
få (adjective)	Svenska är ett språk som talas av få människor, relativt sett. 
få besök (vbm)	Då får jag besök! 
mikrobiolog (noun)	Eller kanske mikrobiolog, för det är min mamma. 
få ihop (vbm)	Åsa skrattar, för hon tror att han aldrig får ihop den. 
till och från (abm)	Hon bor ensam i ett radhus utanför stan och kör bil till och från arbetet. 
militär (adjective)	Kvinnor får också ansöka om militär eller civil utbildning. 
få tag (vbm)	Man kan få tag i biljetter till bra priser genom bussbolagen som ordnar paketpris för resa, musikal och övernattning. 
till sig (jjm)	Jag är både lycklig och stolt, sa han till sig själv. 
fågel (noun)	Ibland stannade vi och lyssnade på fåglarna, och ibland vilade vi på stranden. 
till sist (abm)	Till sist fick jag hennes telefonnummer, och vi snackade om allt, dygnet runt ... 
till slut (abm)	Till slut bestämde vi att vi skulle fortsätta trots allt. 
till slutet (abm)	När du kommer till slutet av Rivstart kan du börja använda en enspråkig ordbok. 
miljö (noun)	Sådan import sliter på miljön. 
miljöfråga (noun)	Hette tidigare Bondeförbundet och är fortfarande ett landsbygdsparti med betoning på miljöfrågor. 
får (noun)	De har djur istället, t.ex. kor, svin, får, höns och kycklingar. 
till ända (abm)	En dag var till ända. 
fårkött (noun)	Ali tänker servera typisk tunisisk mat: mycket fårkött, ris, bönor och grönsaker. 
tillbaka (pl)	När han kom tillbaka kunde han tala hjälpligt, men framför allt kunde han skriva och läsa. 
födelsedag (noun)	Hur ska du fira din födelsedag, då? 
födelsedagsbarn (noun)	Ett fyrfaldigt leve för födelsedagsbarnet! 
tillbringa (verb)	Ibland kan de tillbringa hela helgen där. 
miljövänlig (adjective)	Jag vill forska om miljövänliga bilar. 
föga (adverb)	Det talas minst 140 språk i landet i dag och det har gått snabbt. 
mineralvatten (noun)	Du får bara dricka mineralvatten, inte kranvatten. 
mingla (verb)	I isbaren minglar folk från alla delar av världen och man dricker drinkar i glas av is från älven. 
tillhöra (verb)	Kungen tillhör en internationell släkt. 
minibuss (noun)	Där bor deras lärare, och de ska få skjuts dit av Millans pappa i hans minibuss. 
minigrammatik (noun)	Fler ordningstal, se s 223 i Minigrammatiken. 
minister (noun)	Regeringen består av ungefär tjugo ministrar och chefen för regeringen kallas statsminister. 
tills (sn)	Samtidigt hade jag sagt till mig själv att fortsätta tills jag åkte fast. 
för (adverb)	Hade hon blivit för populär? 
minne (noun)	Dagens intryck bearbetas och fastnar i minnet. 
tillstånd (noun)	Man får tälta en natt på andras marker utan tillstånd men inte på någons tomt, förstås. 
för det mesta (abm)	Malin För det mesta. 
tillträde (noun)	Kvinnorna, som inte hade tillträde till kaffehusen, träffades hemma och drack kaffe och åt kakor. 
för en tid (abm)	För en tid sedan var vi i London och såg Mamma Mia. 
tillverka (verb)	Efter examen arbetade han ett par år på ett företag som tillverkade monteringsfärdiga hus. 
minusgrad (noun)	Vädret är soligt med svag vind, cirka 10 minusgrader och en meter snö. 
för närvarande (abm)	För närvarande finns det omkring 50 lärosäten i Sverige och skillnaden mellan universitet och högskola minskar. 
tilläggspension (noun)	Vi fick obligatorisk allmän tilläggspension = ATP. 
minut (noun)	I genomsnitt ägnar svenska kvinnor 81 minuter och svenska män 64 minuter per dag åt Facebook. 
mirakel (noun)	Medan du sover kan mirakel hända ... 
för tillfället (abm)	' För tillfället bor jag hos mina föräldrar, för mitt ex tog vår lägenhet. 
timer (noun)	Tänk på att det finns en timer här också. 
tips (noun)	Han har inte diskat kastrullerna och han har glömt att lämna in tipset. 
förbereda (verb)	Vill man förbereda sig för att studera vidare på universitetet efter gymnasiet väljer man en mer teoretisk utbildning. 
förbindelse (noun)	Olika delar av foten har nämligen förbindelse med olika organ i kroppen, förklarade han. 
misstänka (verb)	De misstänkte ingenting i början. 
titta in (vbm)	Vi tittar in i deras tält! 
misstänksamhet (noun)	Risken finns att en person som undviker samvaron med sina kolleger under fikarasten betraktas med viss misstänksamhet. 
tjata (verb)	Då skriker hon: Tjata inte! 
mitt (noun)	Kvinnan i mitten har en vit sjal på huvudet och en över axlarna. 
tjejkompis (noun)	Men jag och mina gamla tjejkompisar försöker ses en gång i månaden. 
mitt i (ppm)	Mitt i Jönköping går Östra Storgatan. 
tjock (adjective)	Under de tjocka, täta grenarna i en stor, snötäckt gran sitter en liten talgoxe. 
mittemellan (adverb)	Mittemellan kan man säga. 
mittenparti (noun)	Centerpartiet (c) är ett mittenparti. 
före detta (jjm)	De hade sitt kontor i ett före detta kök på 13 kvadratmeter på Drottninggatan i centrala Stockholm. 
föredra (verb)	Om älgarna inte föredrar sockerblandning talar mycket för att man ska börja använda sockerblandningen på vägarna. 
tjugondag (noun)	Kastar ut granen på tjugondag Knut. 
mjölk (noun)	Varje ko ger i genomsnitt cirka 8 400 liter mjölk per år. 
tjugoåtta (numeral)	Tjugoåtta, sa expediten som om det varit en ren bisak som hon bara nämnt i största förbigående. 
mobil (noun)	Och retar oss på att folk pratar i mobilen vid fel tillfällen. 
föremål (noun)	Fråga: Vilket föremål bär du alltid med dig? 
förening (noun)	Hon är med i flera föreningar och är ofta borta på kvällarna. 
mobiltelefonabonnemang (noun)	Nästan nio av tio svenskar har ett mobiltelefonabonnemang, privat eller genom arbetet. 
modell (noun)	Det är en ny modell. 
tjänsteman (noun)	Och det är precis vad tjänstemannen avser. 
tjänsteresa (noun)	Jag är på tjänsteresa på tisdag och onsdag. 
modern (adjective)	Dessa singelmammor är en modern företeelse. 
tjänstgöring (noun)	Under tjänstgöringen är kläder, mat och husrum gratis och man har rätt till en gratis hemresa per vecka. 
mogna (verb)	Mor: De har nog inte mognat än. 
tobak (noun)	Men folk har tobak under läppen i stället. 
tobaksaffär (noun)	Jag frågar kvinnan i tobaksaffären. 
monarki (noun)	Sverige, Norge och Danmark är monarkier och har en kung eller drottning som statschef. 
tofs (noun)	Skorna är också svarta, och runt knäna har han röda tofsar. 
tolk (noun)	Han ville bli tolk. 
tolka (verb)	Dina ögon ser texten och din hjärna tolkar innehållet och du tänker: Vilken konstig text! 
montera (verb)	Har du monterat den? 
monteringsfärdig (adjective)	Efter examen arbetade han ett par år på ett företag som tillverkade monteringsfärdiga hus. 
tom (adjective)	Man får tälta en natt på andras marker utan tillstånd men inte på någons tomt, förstås. 
moped (noun)	Det får alla som är över 15 år, men Emil vill inte ha moped. 
tomat (noun)	Därför importerar vi t.ex. tomater från Holland, gurka från Spanien och apelsiner från Israel. 
förgifta (verb)	en jumbojet förgiftar 2 miljoner liter luft i sekunden när den startar. 
tomt (noun)	Och husen kan ha en stor eller liten tomt. 
mor (noun)	Han gick då till modern för att beklaga sig. 
moral (noun)	Etik och moral är viktiga frågor för partiet. 
förklara (verb)	Han mötte det han hellre säger på engelska än förklarar på svenska, the spirit of place. 
tonåring (noun)	Mitt förslag är att tonåringarna ska få sovmorgon varje dag. 
förkläde (noun)	Hon har en mörkgrön kjol och över den ett skärt förkläde. 
morgondag (noun)	C: Nej då, men tänk på morgondagen! 
toppjobb (noun)	Och egentligen är det väl enda sättet att få in fler kvinnor på toppjobben som höga chefer. 
förlora (verb)	Först efter 1809, då Sverige förlorade Finland, fick Sverige sin nuvarande sträckning från norr till söder. 
torg (noun)	Vi köper jordgubbar på torget och i mataffären, eller åker och plockar själva på självplock. 
torka (verb)	så får du torka mig. 
torkrum (noun)	I fastigheten finns Tvättstuga, Torkrum, Cykelförråd och Förråd. 
torktumlare (noun)	I badrummet finns tvättmaskin och torktumlare. 
morsa (noun)	EMIL: Det är säkert morsan som ringer. 
torr (adjective)	Det tog flera timmar innan mina kläder var torra igen. 
torsk (noun)	Mona: Ja, jag tar torsk med pepparrotssmör och kokt potatis. 
motion (noun)	Motionerna behandlades av riksdagen året efter det andra världskriget slutade. 
motionera (verb)	Många svenskar, både gamla och unga, motionerar på olika sätt. 
förmögen (adjective)	Hon kom från en förmögen och kulturellt intresserad familj som tyckte mycket om den charmiga Anders Zorn. 
förmögenhet (noun)	Han ägde fabriker i många länder och när han dog 1896 hade han en förmögenhet på 31 miljoner kronor. 
torva (noun)	jag sett skördarna gro på min torva i ro, 
total (adjective)	Den utgör ungefär en fjärdedel av den totala sömnen. 
tradition (noun)	Värnar om traditioner och privat äganderätt. 
traditionell (adjective)	Där brukar de ofta äta en riktigt traditionell söndagsmiddag mitt på dagen. 
motor (noun)	I stället sökte jag arbete på en mekanisk verkstad som tillverkade motorer. 
motorcykel (noun)	Det är jättedyrt med motorcykel. 
trafik (noun)	Kanske är orsaken att det sedan gammalt är män som har hand om trafiken och bilarna. 
förort (noun)	Efter två månader hyrde de en liten tvåa * i en förort till Stockholm. 
trafikolycka (noun)	I går inträffade en trafikolycka på E6:an mellan Malmö och Vellinge. 
motsatspar (noun)	Lär dig adjektiv i motsatspar, t ex: stor liten. 
förrän (sn)	Men det skrämde henne, så hon skrev ingenting förrän hon hade hunnit bli 37 år. 
förråd (noun)	I fastigheten finns Tvättstuga, Torkrum, Cykelförråd och Förråd. 
försiktig (adjective)	Det handlar om att vi måste vara försiktiga med vår miljö. 
mp (noun)	Miljöpartiet De Gröna (mp) har en decentralistisk ideologi, där samspelet mellan människa och natur är viktigt. 
mugg (noun)	Och titta, någon har använt min fina gula mugg. 
förskola (noun)	De flesta barn går i förskola (dagis). 
förskoleklass (noun)	Klara går i förskoleklass och vill gärna börja i riktiga skolan. 
trappa (noun)	Det är 4 trappor upp, men det finns ingen hiss. 
försova sig (vbm)	I går till exempel försov hon sig och bilen startade inte. 
mun (noun)	Man har sagt att hon log med stängd mun för att hon hade dåliga tänder. 
muntlig (adjective)	Hennes språk är klart och enkelt och liknar ibland muntligt berättande. 
första gången (abm)	Jag var tjugosex år när jag trampade Stockholms gator för första gången. 
första klass (nnm)	Man börjar första klass vid sju års ålder och slutar vid 16 års ålder. 
första maj (abm)	Midsommar, Lucia, valborgsmässoafton, första maj, kungen, drottningen, riksdagen, regeringen, demokrati, Ingmar Bergman, Björn Borg, Greta Garbo, Birgit Nilsson. 
trea (noun)	När jag gick i trean hände något hemskt. 
museum (noun)	John går från Moderna museet till Stortorget. 
tredjedel (noun)	Ungefär två tredjedelar av gästerna kommer från utlandet. 
tretton (numeral)	Knut: Jag kommer faktiskt inte ihåg ... ... text tretton, tror jag. 
treårig (adjective)	Från 2000 finns det 17 olika nationella program, samtliga är treåriga. 
mycken (adjective)	Nej, vi är i B-huset för det mesta. 
försvar (noun)	Värnplikten gör man inom det militära försvaret, inom armén, marinen eller flygvapnet. 
försvara (verb)	Men att försvara Sverige innebär mer än soldater och stridsvagnar. 
mygg (noun)	Vi såg många djur ; mest mygg. 
försvarsplikt (noun)	År 1995 fick Sverige en ny lag om total- försvarsplikt. 
mysig (adjective)	Åsa: Men det är mysigare när det är lite mörkt. 
mäklare (noun)	Mäklaren: Ja, vi har faktiskt en fin, ny tvåa i centrum. 
mänga (verb)	Mänga olika goda fruktjuicer att dricka ekologiska förstas. 
mänska (noun)	Han väl visste, han väl visste att en mänska var 
trots (preposition)	Det var ju trots allt ett radikalt ingrepp i människors vana. 
märka (verb)	Jag märkte ingen nytta av mitt arbete, tyckte att jag satte plåster på böldpest. 
trots allt (abm)	Trots allt levde de ganska bra, tyckte hon. 
trottoar (noun)	Folk cyklar på trottoaren fast det inte är tillåtet. 
förut (adverb)	jag aldrig drömt förut 
förutan (preposition)	Vem kan segla förutan vind? 
förutom (preposition)	Förutom riksdagsval kan man ha folkomröstningar i Sverige: 
trumpet (noun)	Svar: Att kunna spela trumpet. 
tryck (noun)	Tryck in koden här och tryck sedan på den gröna knappen. 
trycka (verb)	Han masserade en fot i taget och klämde och tryckte. 
mätt (adjective)	Den mätta dagen den är aldrig störst. 
mål (noun)	Dessutom hade jag som mål att ta för runt 1 000 kronor i veckan. 
måltid (noun)	Till middag, slutligen, äter du däremot en lätt måltid med mycket grönsaker. 
mån (noun)	4.399 kr/mån 
månadsavgift (noun)	Thomas: Jamen, månadsavgiften var ju jättehög på lägenheten, 
träd (noun)	Klara: Det är bara trädet utanför som låter. 
förvåna (verb)	Många utlänningar förvånas över de många fikarasterna på de svenska arbetsplatserna. 
förändra (verb)	Saker och ting förändras. 
trähus (noun)	Nästan alla hus på landet är röda trähus. 
mås (noun)	Måsarna skriker i luften. 
måttlig (adjective)	C: Jag ska se ... Norrland, Svealand ... Götaland ... här har vi det: Måttlig till frisk vind. 
möbel (noun)	Nu har väl de flesta svenskar någon möbel från IKEA hemma. 
g (noun)	G: Jag behöver örhängen också! 
träning (noun)	På fredag är det träning igen och på lördag tänker han vara hemma och tvätta och städa. 
möbelvaruhus (noun)	Hans livsverk är ett stort möbelvaruhus, IKEA. 
möblera (verb)	Per Albin Hansson * skapade folkhemmet och Ingvar Kamprad möblerade det, brukar det heta. 
galen (adjective)	Philippes vänner hemma i Frankrike tycker att han är galen. 
mödravårdscentral (noun)	Linda och Hassan är på mödravårdscentralen. 
möjlighet (noun)	att komma till anonymiteten och möjligheterna i en storstad. 
mönstra (verb)	Alla män mellan 18 och 24 år måste mönstra. 
träsko (noun)	På fötterna, slutligen, har hon gula träskor. 
mönstringsdag (noun)	Ju närmare mönstringsdagen jag kom, desto mer nervös och pressad blev jag. 
gapa (verb)	Kan du gapa stort så ska jag titta i halsen. 
tråka ut (vbm)	Fråga: Vad tråkar ut dig? 
garage (noun)	M: Ja, den står i garaget, och den fungerar bra nu. 
mörkblå (adjective)	Förra veckan kom jag hem med en jättesnygg mörkblå slips, trodde jag. 
gardin (noun)	Det finns tre fönster också och gardiner. 
mörkgrön (adjective)	Hon har en mörkgrön kjol och över den ett skärt förkläde. 
trög (adjective)	trög väg på grus, 
mörkröd (adjective)	Lisa tar emot oss och vi sätter oss i hennes mörkröda soffa. 
mössa (noun)	Tina såg mycket proffsig ut i en blå och vit overall, vita pjäxor och en blå mössa. 
tröttna (verb)	Då tröttnar de nog snabbare. 
gatuhörn (noun)	Jag frågar polisen i gatuhörnet. 
tuberkulos (noun)	Många dog i tuberkulos och många barn dog före ett års ålder. 
tuff (adjective)	Då kom polisen och tog de tuffa killarna och jag såg att en hade näsblod. 
ge (verb)	Men ger sådana turistfällor oss en sann bild av hur sydafrikaner och tanzanier lever? 
müsli (noun)	Till frukost äter du en tallrik gröt eller en tallrik filmjölk med müsli. 
ge sig (vbm)	Men ger sådana turistfällor oss en sann bild av hur sydafrikaner och tanzanier lever? 
naken (adjective)	I bastun är alla nakna. 
ge sig iväg (vbm)	Klockan fem satt hon och far (=farfarsfar) och åt frukost, och halv sex gav sig far iväg. 
ge upp (vbm)	Men Daniel ger inte upp * så lätt. 
tummen mitt i handen (nnm)	Daniel har tummen mitt i handen. 
gemensam (adjective)	Gemensam vårdnad om barnen efter separationen är vanligast nu. 
nation (noun)	Sverige var den tredje största musikexporterande nationen efter USA och Storbritannien år 2002. 
genast (adverb)	Janne prövade att starta, och nu gick bilen genast igång. 
tunisisk (adjective)	Ali tänker servera typisk tunisisk mat: mycket fårkött, ris, bönor och grönsaker. 
tunn (adjective)	Vi blandar rågen med vatten och salt och gör tunna, hårda bröd, som heter knäckebröd. 
general (noun)	Karl var sårad och befallde att generalerna Lewenhaupt och Rehnskiöld skulle leda slaget. 
tunnel (noun)	Förbindelsen, som i själva verket består av en bro, en ö och en tunnel, är totalt 16 km lång. 
nationalmuseum (noun)	Köparen var mycket nöjd, men i måndags meddelade en expert på Nationalmuseet att tavlan inte är av Zorn. 
genetik (noun)	Hon är läkare från Algeriet men just nu forskar hon om genetik. 
tunnelförbindelse (noun)	1991 kom de svenska och danska regeringarna till slut överens om en bro- och tunnelförbindelse. 
nationell (adjective)	Från 2000 finns det 17 olika nationella program, samtliga är treåriga. 
tur (noun)	Du kommer att ha tur i vår. 
genomsnitt (noun)	Stockholmarna tjänar mer än göteborgarna i genomsnitt. 
gentleman (noun)	HANNA: Är du en sådan gentleman? 
turné (noun)	Sofia åkte med sin kör på turné till de baltiska länderna. 
naturresurs (noun)	I Norrland finns stora naturresurser: skog, vattenkraft och malm. 
get (noun)	Ät min get som heter Stjärna. 
gevär (noun)	Det finns inga soldater mer, det finns inga gevär 
naturtillgång (noun)	Sverige det är rena gator, gröna parker, rika naturtillgångar: skogar, järn, älvar. 
naturvetenskaplig (adjective)	Jag läste naturvetenskapligt program på gymnasiet och sedan började jag på Chalmers tekniska högskola i Göteborg. 
naturvetenskapsprogram (noun)	Det finns praktiska program som till exempel fordonsprogrammet och teoretiska program som naturvetenskapsprogrammet. 
tv-reparatör (noun)	När Sofia var 18 år träffade hon Tobias, en 19- årig TV-reparatör från Småland. 
tv-rum (noun)	Jag har födelsedag och mamma och pappa kommer att vara hemma fast de kommer att vara i tv-rummet. 
giftig (adjective)	Den runda fisken i mitten är ganska farlig, för den är giftig. 
tv-serie (noun)	Jag ska vara med i en tv-serie. 
tveka (verb)	Anna tvekade en liten stund innan hon lämnade sin adress i Sverige på en liten papperslapp. 
gissa (verb)	De flesta gissar rätt ungefär varannan gång. 
tvinga (verb)	Du tvingas iaktta alla dom små muskeltrådar som arbetat där sedan födseln. 
nedgång (noun)	Mellan 1 mars och 31 oktober hissar man flaggan klockan åtta och halar den vid solens nedgång. 
tvärgata (noun)	Du tar första tvärgatan till vänster. 
glasbruk (noun)	Hon arbetade på ett glasbruk. 
tvärtom (adverb)	I USA är det precis tvärtom. 
tvätt (noun)	Och jag har hängt tvätten i badrummet. 
glass (noun)	Där köper hon också glass till efterrätt och lök till pajen. 
tvättmaskin (noun)	I badrummet finns tvättmaskin och torktumlare. 
tvättstuga (noun)	Hur har du det i din tvättstuga? 
glitter (noun)	Äntligen är skoldagen slut, och eleverna får gå hem, många fortfarande med glitter i håret. 
tvättställ (noun)	Ett badrum/wc med badkar, tvättställ och kakel samt ett WC med toalett, tvättställ och kakel. 
nej-sida (noun)	Ja-sidan vann med 52,3 procent mot nej-sidans 46,8 procent. 
glob (noun)	På kvällen går Jonas och Daniel på konsert i Globen. 
tvåa (noun)	Jag har precis flyttat ihop med Kajsa i en liten tvåa. 
ner (adverb)	Längst ner på ena byxbenet hade han rester av skokräm. 
tvåhundra (numeral)	Hur mycket får vi för tvåhundra kronor? 
tvåspråkig (adjective)	Använd en tvåspråkig ordbok i början. 
nervös (adjective)	Jag tycker inte om att sova borta och sedan är det ju nervöst att lämna huset alldeles tomt. 
glögg (noun)	De bjuder läraren och hans fru på kaffe, bullar och pepparkakor, och läraren bjuder dem på glögg, alkoholfri förstås! 
tycka om (vbm)	Det kommer svenskarna nog att tycka om. 
tyda (verb)	Ingen kan tyda dess lagar. 
tyg (noun)	Det fanns speglar, som gick ända ner till golvet, och stolar klädda med rött tyg som kanske var plysch. 
gny (noun)	Jag sett vårarna gry, jag hört höststormar gny, 
nia (noun)	De gick fram till de stora killarna i nian och sa nåt, men jag hörde inte vad. 
typ (noun)	De är bara typ kompisar. 
god dag (inm)	Fru G: God dag! 
godhet (noun)	Han kommer att märka din godhet och ni blir mycket lyckliga tillsammans! 
godis (noun)	Och så skulle jag köpa en affär med godis och glass. 
tyst (adjective)	Vi är tysta båda två men ingenting är som förut. 
tältplats (noun)	Just nu tältar de på en tältplats i Värmland. 
golf (noun)	Philippe har två stora intressen: skidor och golf. 
tältöppning (noun)	står det på en skylt ovanför tältöppningen. 
nobelpristagare (noun)	Då äter årets nobelpristagare middag tillsammans med kungen och drottningen och flera hundra andra gäster. 
nog (adverb)	Fast man kommer nog att ha dåligt samvete mot mamma. 
noga (adverb)	Han duschade och tvättade sig extra noga, rakade sig och borstade tänderna. 
golvlampa (noun)	Golvlampan ställer han bakom fåtölj en. 
tänka om (vbm)	Tänk om det blir tvillingar! 
tänka sig (vbm)	Att attityder i trafiken kan variera mellan orter, kan Lars Åberg mycket väl tänka sig. 
gott nytt år (inm)	Gott slut och ett gott nytt år! 
tärna (noun)	Ät vem då, du lilla tärna? 
gott slut (inm)	Gott slut och ett gott nytt år! 
nordisk (adjective)	Sverige var näst sist bland de nordiska länderna med att införa en jämställdhetslag. 
grabb (noun)	Gunnar: Vad tyckte du om kastspöet som Magnus fick av oss grabbar? 
tätort (noun)	Idag har vi ungefär dubbelt så många invånare och 75 procent bor i städer eller tätorter. 
gram (noun)	Vi pratar om gram eller kilo. 
tå (noun)	på lingonröda tuvor komma dansande på tå. 
grammatisk (adjective)	Använd en ordbok där orden har grammatisk information, t ex en/ett och verbformer. 
grammofon (noun)	Grammofon får hon förstås spela, men hon måste tänka på grannarna också. 
gran (noun)	Kastar ut granen på tjugondag Knut. 
tår (noun)	Vem kan skiljas från vännen sin utan att fälla tårar? 
gratis (adjective)	Under tjänstgöringen är kläder, mat och husrum gratis och man har rätt till en gratis hemresa per vecka. 
gratis (adverb)	Under tjänstgöringen är kläder, mat och husrum gratis och man har rätt till en gratis hemresa per vecka. 
gratulera (verb)	Det ringer på dörren, och Bosse kommer och gratulerar med ett paket. 
törstig (adjective)	Vi måste säga adjö till våra stora, starka och törstiga bilar. 
nota (noun)	Kan vi få notan. 
ugn (noun)	Det finns en dusch, en toalett, en spis, ett kylskåp, en ugn och en diskbänk och flera skåp. 
november (noun)	Mellan 1 november och 28 februari hissar man flaggan klockan nio och halar den senast klockan tre. 
nr (noun)	Skåne, nr 4, är också ett landskap, men det ligger i södra Sverige. 
ull (noun)	Från hönsen får vi ägg, från fåren ull och kött, från svinen fläsk och från korna kött och mjölk. 
nubb (noun)	Berit: Brian, kan du skicka mig nubben. 
nuförtiden (adverb)	Fredrik: Vad gör du nuförtiden då? 
gro (verb)	jag sett skördarna gro på min torva i ro, 
grop (noun)	Den som gräver en grop åt andra, faller själv däri. 
under tiden (abm)	Under tiden var inte mor sysslolös. 
grovarbetare (noun)	Far var grovarbetare, men han var ofta arbetslös. 
nybörjarkurs (noun)	Anna började på en nybörjarkurs i spanska. 
grunda (verb)	Arbetarna började organisera sig i fackföreningar och Socialdemokratiska arbetarepartiet grundades år 1889. 
nyckel (noun)	Han har nämligen glömt nycklarna till lägenheten i Stockholm hos en god vän i Malmö. 
nyckelharpa (noun)	Fiol och nyckelharpa ... 
underkläder (noun)	Sedan tog han fram rena underkläder och strumpor och en ny, vit skjorta och klädde på sig. 
grundskola (noun)	Alla svenska barn går nio år i grundskolan. 
grundutbildning (noun)	Efter grundutbildningen får varje man/kvinna ett utryckningsbidrag på 4 500 kronor. 
nyhet (noun)	Invandrare träffas där för att få nyheter från sina hemländer och prata med varandra. 
grupp (noun)	Man måste inte bara hålla reda på alla i gruppen utan även på deras relationer sinsemellan. 
nykterhetsrörelse (noun)	Jag blev medlem i facket där, och jag var också med i nykterhetsrörelsen. 
undersökningsrum (noun)	Han går in i undersökningsrummet och väntar på läkaren. 
grusväg (noun)	Till höger efter färjeläget och sedan till vänster in på en liten grusväg. 
undervisa (verb)	Här kommer vi in, jag och andra lärare och undervisar er varje vecka, dag ut och dag in. 
nypotatis (noun)	Dansar kring midsommarstången och äter sill 4 och nypotatis och jordgubbar på midsommarafton. 
gräl (noun)	Stor risk för missförstånd och gräl. 
gräla (verb)	I går kväll grälade han med Linda. 
undra (verb)	Han undrade själv många gånger. 
ungdom (noun)	Ulla-Britt Kotsinas, numera biträdande professor i nordiska språk vid Stockholms universitet, gjorde då ett forskningsarbete om ungdomars speciella gruppspråk. 
nytta (noun)	Det kallar jag att förena nytta med nöje! 
nyttig (adjective)	Ar det så svårt att laga god och nyttig mat? 
nyår (noun)	Jag började lite efter nyår, men jag hann inte så långt. 
gräva (verb)	De gräver och planterar och krattar löv och väntar på sommaren. 
nyårsafton (noun)	På nyårsafton ska man avlägga nyårslöften. 
nyårslöfte (noun)	På nyårsafton ska man avlägga nyårslöften. 
nä (interjection)	Maja Nä, det tror jag inte, men hela trädgården står under vatten, så vårblommorna har säkert blivit förstörda. 
unge (noun)	Annars var inte lärarna så nådiga mot ungarna på den tiden! 
grå (adjective)	De har en grå rand! 
ungersk (adjective)	Naturligtvis älskar han engelskt öl, men han dricker gärna ungerskt vin till maten. 
nämligen (adverb)	Jag älskar nämligen också att gå vilse. 
gråt (noun)	och gråten är min, när du gråter. 
gråta (verb)	och gråten är min, när du gråter. 
unik (adjective)	Den är ganska unik i världen. 
grön (adjective)	En vit tröja med gröna ränder och likadana strumpor. 
nära (adverb)	Det finns närmare tusen olika teckenspråk i världen. 
nära (adjective)	Helena har alltid haft väninnor och nära vänner omkring sig. 
grönsak (noun)	Till middag, slutligen, äter du däremot en lätt måltid med mycket grönsaker. 
universitetsstudie (noun)	Hela sommarlovet stannar de i Sverige, sedan tar de båten hem till Polen och universitetsstudierna igen. 
grönsaksdisk (noun)	Vid grönsaksdisken tar hon sex tomater, en gurka och en isbergssallad och lägger i korgen. 
universitetsutbildning (noun)	35 procent av Sveriges befolkning mellan 25 och 64 år hade högskole- eller universitetsutbildning. 
upp (adverb)	Det är 4 trappor upp, men det finns ingen hiss. 
näringsliv (noun)	vill ha ett fritt näringsliv, men också sociala reformer. 
gröt (noun)	Till frukost äter du en tallrik gröt eller en tallrik filmjölk med müsli. 
upp och ner (abm)	Du lägger pappret upp och ner. 
upp på (ppm)	Taklampan hänger han i taket och affischerna sätter han upp på väggen. 
guide (noun)	De är ganska bra guider för Daniel är ju född här. 
uppe (adverb)	Uppe vid polcirkeln ligger samhället Överkalix. 
näsa (noun)	Du skriver att du har en jättestor näsa. 
uppehåll (noun)	Mulet men mest uppehåll. 
guld (noun)	Här har vi ett par äkta guld och diamanter i 18 karat! 
nät (noun)	Hassan: Du kan väl börja med att titta på annonserna på nätet i stället. 
uppfinna (verb)	Han uppfann datormusen för att kunna lägga in diagram på datorn. 
uppfinnare (noun)	Den 10 december 1896 dog kemisten och uppfinnaren Alfred Nobel. 
uppfinning (noun)	Uppfinningen av dynamit gjorde Nobel rik. 
nättidning (noun)	En nättidning frågade 648 personer om mat och restauranger. 
guldsmedsaffär (noun)	Fru Gyllenrik går in i en guldsmedsaffär: 
någon gång (abm)	Har du någon gång tänkt tanken att kanske göra något annat? 
någonstans (adverb)	Så fort vi reser någonstans har hon massor av vykort att skriva. 
någonting (prounoun)	Det är någonting med blicken, sättet att tala. 
nåja (interjection)	J: Nåja, det brukar ju vara rätt kallt på Valborg. 
uppgift (noun)	Under civilplikten får man lära sig hur viktiga uppgifter i samhället sköts i en krigssituation. 
uppgå (verb)	Idag uppgår ett nobelpris till ungefär 9 miljoner kronor. 
gurka (noun)	Därför importerar vi t.ex. tomater från Holland, gurka från Spanien och apelsiner från Israel. 
nöjd (adjective)	Snarare är det så att de verkar både gladare och nöjdare. 
nöjesfält (noun)	Vi är på ett nöjesfält. 
gym (noun)	På onsdag ska han gå till gymet igen. 
gymnasiekompetens (noun)	Där kan man läsa många olika ämnen och få grundskole- och gymnasiekompetens. 
gymnasieskola (noun)	I slutet av 1990-talet fortsatte hela 98 procent till gymnasieskolan. 
o (conjunction)	S Z A B O. 
gymnasieutbildning (noun)	Det är mycket svårt att hitta ett arbete direkt efter grundskolan, så gymnasieutbildningen är viktig. 
o (noun)	Lisa: a-r-o-n s-s o-n 
gymnasium (noun)	Emil går i gymnasiet och är ganska trött på skolan. 
uppmärksamhet (noun)	Man tackar för maten, man tackar för sällskapet, man tackar för lånet, man tackar för uppmärksamheten. 
gälla (verb)	Det är här och nu som gäller. 
obebodd (adjective)	En stor del av Sverige är alltså obebott. 
upprepa (verb)	Upprepas samma ord flera gånger? 
gäng (noun)	Men vi vande oss fort och är man bara sig själv så blir man snabbt en i gänget. 
gärd (noun)	som sol över mörka gärden. 
obestämd (adjective)	Bestämd eller obestämd form? 
gästforskare (noun)	Hon bor med sin familj i en lägenhet som Kl hyr ut till gästforskare. 
obligatorisk (adjective)	Vi fick obligatorisk allmän tilläggspension = ATP. 
gästnatt (noun)	I dag har hotellet ca 15 000 gästnätter per säsong. 
gå bra (vbm)	Men på vintern går det bra! 
gå igen (vbm)	På onsdag ska han gå till gymet igen. 
och så vidare (abm)	Du frågar om skatter, kriminalitet och så vidare, och jag vet inte vad jag ska svara. 
gå igenom (vbm)	och svenskt kulturliv och går igenom programmet gång på gång. 
ock (adverb)	därför han ock, därför han ock vin planterat har. 
odla (verb)	Men många odlar nästan ingenting. 
uppstå (verb)	Hur uppstod fenomenet Diana? 
gå vägen (vbm)	Han hade fem kilometer till sågverket och måste gå hela vägen. 
gå över (vbm)	Men snart går vi över till svenska! 
upptäckt (noun)	Tack vare Columbus upptäckt av Amerika kan vi i dag njuta av choklad. 
officiell (adjective)	I Finland är svenska ett officiellt språk. 
gång på gång (abm)	och svenskt kulturliv och går igenom programmet gång på gång. 
uppväxt (noun)	Drottning Silvia kommer från Tyskland men är uppväxt i Brasilien och talar tyska, engelska, franska, portugisiska och svenska. 
uppåt (adverb)	Han är ganska uppåt för han tycker det är skönt att slippa köra på natten. 
ur (preposition)	Det är inte jag, som druckit ur vinet. 
gås (noun)	Äter gås i november. 
ointressant (adjective)	De som jag känner är så tråkiga och ointressanta! 
göra i ordning (vbm)	Syster, gör i ordning en bedövningsspruta. 
göra om (vbm)	Man får göra upp eld (om det inte finns risk för brand). 
ojdå (interjection)	Journalisten: Ojdå, snubblade du? 
göra ont (vbm)	Kommer det att göra ont? 
ursprungligen (adverb)	Ätten Bernadotte kommer ursprungligen från Frankrike. 
göra sig (vbm)	och aldrig göra dig ledsen 
göra slut (vbm)	Hon har precis ringt och gjort slut med Johan. 
göra upp (vbm)	Man får göra upp eld (om det inte finns risk för brand). 
oktober (noun)	Mellan 1 mars och 31 oktober hissar man flaggan klockan åtta och halar den vid solens nedgång. 
olja (noun)	Man måste ju betala en massa saker varje månad, olja och sophämtning till exempel. 
ut ur (ppm)	Där kommer en ung pojke springande ut ur skogen. 
ha fel (vbm)	Jag har bara ett fel: 
ha kvar (vbm)	Och många har kvar sina kolonilotter. 
ha ont (vbm)	Knut: Men du hade ju ont i huvudet? 
olycklig (adjective)	Pappan blir olycklig och börjar dricka. 
ha sitt (vbm)	Men de har var sitt arbete, var sin bostad och var sin ekonomi. 
utbilda (verb)	Jag har en vän, som heter Mats, som går och utbildar sig till massör. 
utbildning (noun)	Men jag kanske kan läsa båda utbildningarna. 
utbildningsnivå (noun)	Bland OECD-länderna (de flesta industriländer i världen) låg Sverige på fjärde plats 2004 när det gäller utbildningsnivå bland befolkningen. 
haka (noun)	Längst till vänster sitter Mattias med hakan i handen. 
om (pl)	Jag ruskar om mig själv. 
hal (adjective)	Det har blivit is på stenen och det är väldigt halt. 
hala (verb)	Mellan 1 mars och 31 oktober hissar man flaggan klockan åtta och halar den vid solens nedgång. 
utbytesstudent (noun)	Studenttidningen har intervjuat några utbytesstudenter i Sverige. 
hals (noun)	Älgen har långa ben och kort hals och älgtjuren har stora horn. 
halsduk (noun)	När Klara kommer till dagis, måste hon ta av stövlar, sockor, vantar, jacka, byxor, halsduk och mössa. 
halstablett (noun)	Han får medicinen direkt, och sedan går han till en kiosk och köper några goda halstabletter och en serietidning. 
halva (noun)	Han heller inte halvan får 
omkring (preposition)	Hennes värld var böckernas värld och hon kunde koncentrera sig fastän syskonen lekte runt omkring henne. 
halvklar (adjective)	På kvällen halvklart, eventuellt sol, 6- 9 grader. 
uteservering (noun)	På uteserveringen på Stortorget om en timme? 
område (noun)	Men kanske mest märkbar är den språkliga domänförlusten inom det naturvetenskapliga området, där engelskan så gott som tagit över. 
halvsyster (noun)	Hans mamma är omgift och han har en liten halvsyster. 
halvtid (noun)	En del arbetar några år, gifter sig, får barn och läser sedan på universitetet, heltid eller halvtid. 
halvö (noun)	Sverige ligger på den Skandinaviska halvön i norra Europa. 
hand (noun)	Blombuketten överlämnades och pappas kyss på handen gjorde Stina litet generad. 
handduk (noun)	Men det där är min handduk! 
handelsgymnasium (noun)	Han slutade skolan 1941 och började på ett handelsgymnasium i Göteborg. 
uti (preposition)	ja, må han leva uti hundrade år. 
utland (noun)	1953 åkte vi för första gången till utlandet på semester. 
utlänning (noun)	I valet till riksdagen får bara svenska medborgare rösta, men i kommunalvalen kan utlänningar också vara med. 
opraktisk (adjective)	Du vet hur opraktiska vi är. 
utmaning (noun)	För att det är en fysisk och psykisk utmaning, men inte för att bevisa något för andra. 
utmärka (verb)	Ålder och kön är de två faktorer som utmärker sensationssökarna mest. 
handväska (noun)	När de kom hem igen upptäckte kvinnan att hennes handväska med pengar, kontokort, körkort och annat var borta. 
utnyttja (verb)	Amos tycker att det gäller att utnyttja alla möjligheter man har för att göra omgivningen lyckligare. 
utom (preposition)	Alla utom en, som jag vill ha grön. 
hantverk (noun)	Andra kommer för att köra hundspann eller lära sig något annorlunda hantverk, som att bygga fioler. 
ordentlig (adjective)	Nu ska du sluta banka och du ska vara en ordentlig pojke, säger Hassan. 
utomlands (adverb)	Varje månad sparar hon 1 000 kr, och sedan åker hon utomlands på semestern. 
hare (noun)	De ser bara rådjur och harar. 
ordförande (noun)	Jag blev mer och mer intresserad av politik, och 1964 blev jag ordförande i verkstadsklubben på jobbet. 
ordna (verb)	Om du fyller i en ansökan om bankomatkort, ska jag ordna det åt dig. 
hata (verb)	Jag hatar att städa. 
hatt (noun)	Hon trodde att hon var jättesmart när hon gömde kycklingen i hatten. 
ordningstal (noun)	Fler ordningstal, se s 223 i Minigrammatiken. 
utryckningsbidrag (noun)	Efter grundutbildningen får varje man/kvinna ett utryckningsbidrag på 4 500 kronor. 
organ (noun)	Olika delar av foten har nämligen förbindelse med olika organ i kroppen, förklarade han. 
organisera (verb)	Jonas Organiserar ni några utomhusaktiviteter också? 
orientalisk (adjective)	Jag kan laga fantastiska, orientaliska rätter. 
hedersman (noun)	Gubben Noak, gubben Noak var en hedersman, 
orka (verb)	Men vi tyckte att det var lika bra att de fick titta så mycket de orkar. 
orkester (noun)	På dansbanan spelar orkestern vals: Que será, será. 
orm (noun)	LÄSTIPS: Röde Orm av Frans G. Bengtsson 
utställning (noun)	Då gjorde japanska konstnärer en utställning med iskonst i Jukkasjärvi, 20 mil norr om polcirkeln. 
orolig (adjective)	Sverige var ju inte med i kriget, men det var en orolig tid. 
uttagsautomat (noun)	Innan de åkte dit tog han ut pengar i en uttagsautomat. 
hektar (noun)	Det finns ungefär 80 000 jordbruk på i genomsnitt 34 hektar (340 000 kvadratmeter) åkrar och ängar. 
ort (noun)	På nästan varje ort i Sverige finns ett bibliotek. 
hekto (noun)	Kunden: Kan jag få ... två hekto, tack. 
uttala (verb)	Att före infinitiv uttalar vi ofta å. 
hela (noun)	Och den som inte helan tar 
hela dagen (abm)	I söndags följde hon inte med på bio, utan hon var hemma hela dagen. 
hela vägen (abm)	Han hade fem kilometer till sågverket och måste gå hela vägen. 
uttalsövning (noun)	Jobba med uttalsövningarna i övningsboken. 
uttryck (noun)	I dessa spalter har uttryck som cykelhuligan myntats. 
helgdag (noun)	Första maj är en helgdag. 
heltid (noun)	En del arbetar några år, gifter sig, får barn och läser sedan på universitetet, heltid eller halvtid. 
ost (noun)	Jag skulle vilja ha lite ost också. 
ostkust (noun)	Sillen är en fisk som lever på ost- och västkusten ; På ostkusten heter den strömming. 
hem (noun)	Timmarna i hemmet, som oftast är den plats 
hembiträde (noun)	Hon arbetade som hembiträde hos en familj i staden. 
heminredning (noun)	Han lärde hela folket heminredning. 
hemland (noun)	Invandrare träffas där för att få nyheter från sina hemländer och prata med varandra. 
ovanför (preposition)	står det på en skylt ovanför tältöppningen. 
ovanlig (adjective)	Han har en ovanlig snabbhet på plan, han är 1,92 m lång och han är en synnerligen duktig tekniker. 
hemresa (noun)	Under tjänstgöringen är kläder, mat och husrum gratis och man har rätt till en gratis hemresa per vecka. 
oväsen (noun)	Jag tycker inte om oväsen! 
oxfilé (noun)	Patrik: Och jag tar oxfilé med kryddsmör och potatisgratäng. 
herr (noun)	Hon har varit borta på en veckas semester och herr Gustavsson har inte vattnat blommorna. 
herre (noun)	Mina damer och herrar! 
valborgsmässoafton (noun)	Midsommar, Lucia, valborgsmässoafton, första maj, kungen, drottningen, riksdagen, regeringen, demokrati, Ingmar Bergman, Björn Borg, Greta Garbo, Birgit Nilsson. 
packa ner (vbm)	Hans mamma frågar honom: Har du packat ner allting? 
packa upp (vbm)	Packa upp och montera den nya bokhyllan. 
paddla (verb)	Vi följde en älv, som heter Svartälven, och paddlade över stora sjöar och genom vackra åar. 
himmel (noun)	och himlen är raggsocksblöt 
vals (noun)	På dansbanan spelar orkestern vals: Que será, será. 
paj (noun)	Där köper hon också glass till efterrätt och lök till pajen. 
paketera (verb)	Hon paketerade glas och skålar fem dagar i veckan och tjänade 1 700 kr i månaden. 
hinna (verb)	Vanligt är att drömma att man ska göra något viktigt men att man inte hinner eller misslyckas. 
vandring (noun)	Jonas och jag är nu i Kiruna, efter en vandring pä ungefär tio mil. 
hiss (noun)	Det är 4 trappor upp, men det finns ingen hiss. 
historisk (adjective)	Fråga: Vilken historisk person beundrar du? 
hit (adverb)	Alla som kommer hit har redan en flickvän. 
vanlig (adjective)	Är det vanligaste efternamnet alltså Svensson? 
panna (noun)	Jag gillar också pytt i panna och biff med lök. 
pannkaka (noun)	En gång i veckan äter han köttbullar, korv, pannkaka och ärtsoppa och fisk av något slag. 
hjortron (noun)	I norra Sverige kan du hitta hjortron, om du har tur. 
hjortronsylt (noun)	En vanlig svensk dessert är glass med varm hjortronsylt. 
hjälm (noun)	Jonas Har du själv hjälm när du cyklar? 
vante (noun)	När Klara kommer till dagis, måste hon ta av stövlar, sockor, vantar, jacka, byxor, halsduk och mössa. 
hjälpa till (vbm)	Han hjälper till i köket en halvtimme i veckan och dammsuger 28 minuter var fjortonde dag. 
papegoja (noun)	Vi har en papegoja, som heter James Bond. 
pappaledig (adjective)	Först var Sofia mammaledig, och sedan var Tobias pappaledig. 
hjälpsam (adjective)	Hon är alltid snäll och hjälpsam. 
var (dt)	Före 1994 hade vi val vart tredje år. 
hjärna (noun)	Störst hjärna har primater som markattor, babianer, schimpanser och människor. 
vara (noun)	Vi går in, tar en korg och går runt och tittar på alla varor och priser. 
vara ihop (vbm)	Är du ihop med honom? 
hjärta (noun)	Men nu står de små matematiska hjärtana tillsammans med ett dsm. 
vara till (vbm)	Malin Min bästis Frida var den som först fattade hur dålig jag var, till och med före mig själv. 
varannan (dt)	Nu träffar han dem bara varannan vecka. 
varav (ha)	Boarea ca 74 kvm, 3 rum varav 2 sovrum. 
vardag (noun)	Nu börjar vardagen * igen. 
vardagsmat (noun)	Det är svensk vardagsmat. 
parfymavdelning (noun)	Det finns många avdelningar på ett varuhus: en parfymavdelning, en sportavdelning, en elavdelning, en skoavdelning osv. 
parhus (noun)	Om man vill bo i hus kan man till exempel välja mellan villa, radhus och parhus. 
park (noun)	Sverige det är rena gator, gröna parker, rika naturtillgångar: skogar, järn, älvar. 
hockeytränare (noun)	På fritiden är jag hockeytränare. 
parkera (verb)	Han parkerar bilen utanför porten och bär tillsammans med en kamrat upp allting och ställer det i korridoren. 
parlament (noun)	Den politiska makten har regeringen och parlamentet, som i Sverige heter riksdagen. 
variant (noun)	Det blir en enklare variant, men den har de viktigaste funktionerna. 
variation (noun)	Är det en variation av huvudsatser och bisatser? 
parti (noun)	Vänsterpartiet (v) är ett socialistiskt parti, som vill avskaffa vänster kapitalismen och klassamhället. 
varlig (adjective)	bara man är varlig. 
hona (noun)	Det är en hona. 
varm korv (nnm)	en korvkiosk och köper en varm korv med bröd. 
varmvatten (noun)	Mäklaren: Men det finns ingen centralvärme och inget varmvatten och inget bad heller förstås. 
passa (verb)	till Någon som passar mej 
hopp (noun)	Helan går, sjung hopp faderej faderallan lej! 
hoppa (verb)	Jag hoppas att han bor någonstans där han aldrig mer behöver frysa. 
hopplös (adjective)	Nej, vårt schema är hopplöst. 
pasta (noun)	Och jag har sett att en del äter ketchup till pasta. 
horn (noun)	Älgen har långa ben och kort hals och älgtjuren har stora horn. 
vart (ha)	Vart ska du gå, min lilla flicka? 
varuhuskedja (noun)	Ann är chef för en stor varuhuskedja. 
hosta (verb)	Jag hostade och hade ont i huvudet. 
hotellrum (noun)	Hotellrum erbjuder en liknande möjlighet att fly invanda tankebanor. 
pedagogisk (adjective)	Du är mer pedagogisk än jag. 
vas (noun)	Men Magnus dammar kanske sin vas själv. 
hugga (verb)	Jag skulle också vilja att de högg ner trädallén på Pärongatan. 
pendeltåg (noun)	Pendeltåget går 10.22 f rår, Centralen mot Nynäshamn. 
pendla (verb)	Man kanske måste pendla till jobbet om man bor utanför stan. 
vattenkraft (noun)	I Norrland finns stora naturresurser: skog, vattenkraft och malm. 
pension (noun)	Dessutom hade hon en pension och barnbidrag ; tillsammans 600 kronor i månaden. 
vattna (verb)	Hon har varit borta på en veckas semester och herr Gustavsson har inte vattnat blommorna. 
hummer (noun)	Sven: Och hummern så färsk. 
vattnig (adjective)	lite vattnigt, tycker du inte? 
pensionärsgympa (noun)	Agneta Vi har naturligtvis också pensionärsgympa. 
hundra (numeral)	Han har handlat för flera hundra kronor. 
pepparkaka (noun)	De bjuder läraren och hans fru på kaffe, bullar och pepparkakor, och läraren bjuder dem på glögg, alkoholfri förstås! 
pepparrotssmör (noun)	Mona: Ja, jag tar torsk med pepparrotssmör och kokt potatis. 
per (preposition)	I genomsnitt ägnar svenska kvinnor 81 minuter och svenska män 64 minuter per dag åt Facebook. 
veckotidning (noun)	Medan han väntar försöker han läsa en veckotidning, men han kan inte koncentrera sig, för han är så nervös. 
ved (noun)	Saras pappa Kurt-Allan står och hugger ved. 
vedspis (noun)	De gamla strykjärnen värmde man på vedspisen. 
vegetarian (noun)	Här i Umeå är många unga människor vegetarianer. 
vegetarisk (adjective)	Ekologisk, vegetarisk mat i lugn miljö. 
vem (hs)	Lina: Vems strumpor är det där då? 
vem som helst (pnm)	Där kan vem som helst låna böcker och tidskrifter gratis. 
personal (noun)	Personalen ringer till Klaras mamma på jobbet, och Ellen skyndar sig till dagis. 
hurdan (adjective)	TOVE: Hurdan är han då? 
verbform (noun)	Använd en ordbok där orden har grammatisk information, t ex en/ett och verbformer. 
husbåt (noun)	Eller man kan bo på vattnet, i en husbåt. 
verka (verb)	Det verkar som om den yngre generationen söker ett uttryck för respekt, hövlighet eller bara för att markera distans. 
verkligen (adverb)	Du är verkligen omtänksam, skrev jag, med det svenska ordet omtänksam. 
hushåll (noun)	Han tryckte massor av kataloger, och han delade ut dem gratis till hushållen. 
hushållsarbete (noun)	Fatoush jobbar ofta över så hon hinner inte göra så mycket av hushållsarbetet. 
verkstad (noun)	I stället sökte jag arbete på en mekanisk verkstad som tillverkade motorer. 
verkstadsklubb (noun)	Jag blev mer och mer intresserad av politik, och 1964 blev jag ordförande i verkstadsklubben på jobbet. 
huslig (adjective)	Jag är mycket huslig, jag gillar att laga mat, städa, tvätta och stryka. 
husrum (noun)	Under tjänstgöringen är kläder, mat och husrum gratis och man har rätt till en gratis hemresa per vecka. 
vernissage (noun)	Aret efter hade en fransk konstnär vernissage i en igloo. 
husvagn (noun)	De bor inte på hotell, för de har en husvagn, en stor husvagn med plats för fyra personer. 
huvud (noun)	Jag skakar på huvudet och låter så förnärmad jag kan. 
pilkastning (noun)	Bland karuseller, berg- och-dalbanor, stånd med pilkastning, lotterier och varmkorv sitter en spågumma i ett tält. 
veta om (vbm)	Vet du om det finns någon pressbyråkiosk här i närheten? 
pilot (noun)	Jag älskar att flyga, så jag vill bli pilot. 
vete (noun)	Bönderna odlar t.ex. vete, råg, raps och potatis, och många äger skog också. 
huvudkontor (noun)	Det var från huvudkontoret i Genève. 
pingstafton (noun)	Firar bröllopsdagen på pingstafton. 
vetenskapsman (noun)	Celsius reste runt i Europa och besökte olika vetenskapsmän och universitet. 
veterinär (noun)	Men jag tycker om djur också, så jag ska kanske bli veterinär. 
vett och etikett (nnm)	Therese är expert på vett och etikett. 
pip (noun)	Lämna ditt namn och telefonnummer efter pipet så kontaktar jag dig sedan. 
pipa (noun)	Då ökade också cigarettkonsumtionen markant medan man började röka mindre cigarr och pipa. 
huvudvärk (noun)	Jag blev alldeles lugn och sömnig, och huvudvärken gick över! 
huvudvärkstablett (noun)	DAVID: Vill du ha en huvudvärkstablett? 
hygglig (adjective)	Men med en hygglig prosodi och hög talhastighet kamoufleras ordsluten så att lyssnaren inte märker så många fel. 
vid första ögonkastet (abm)	Det är kärlek vid första ögonkastet! 
hylla (noun)	Lådorna med julsaker har däremot klarat sig för de stod på en hylla. 
pizza (noun)	GUNILLA: Jag tycker inte om att promenera och jag gillar inte pizza. 
hyra ut (vbm)	Hon bor med sin familj i en lägenhet som Kl hyr ut till gästforskare. 
pizzeria (noun)	Han jobbade på en pizzeria på dagarna och läste språk på kvällarna. 
hyresgästförening (noun)	(Källa: Hyresgästföreningen, 2005, Svt.se, 2006.) 
video (noun)	Ca 98 % av hushållen i Sverige har TV och 2 av 3 hushåll har video. 
plan (noun)	Jag gillar inte planerna på att utöka dagens hjälmtvång för motorcyklister och mopedister till att även omfatta cyklister. 
hyreskontrakt (noun)	Efter ett antal år med missbruk av tyngre droger och socialbidrag finns det ingen chans att få ett hyreskontrakt. 
planering (noun)	Ann är mycket nöjd med planeringen, men hon är ganska trött nu. 
videofilm (noun)	En del videofilmer får hon inte titta på, och hon får inte sitta framför teven hela kvällen. 
hyreslägenhet (noun)	Men jag vill ha en hyreslägenhet. 
plantera (verb)	plantera ' han på marken 
plast (noun)	När Rolf och Annika kommer in i lägenheten måste de sätta på sig blåa skoskydd av plast över skorna. 
hälft (noun)	Sedan dess har över hälften försvunnit, och många fler är hotade. 
hälla (verb)	Så tänder man en cigarr, häller upp ett glas champagne och skålar. 
viking (noun)	Till honom offrade vikingarna för att få lycka i striden. 
hälsning (noun)	Däremot avslutar man oftast formella brev med frasen Med vänlig hälsning. 
platt (adjective)	I norr dominerar berg, fjäll och skogar men i söder är landskapet platt. 
viktig (adjective)	Det var på den tiden då de två viktigaste skolböckerna var Bibeln och skolatlasen. 
plocka (verb)	Mor: Nej, det har varit folk här och plockat före oss. 
plocka upp (vbm)	Man tror att dessa levde av mindre eller medelstora byten som de plockade upp och svalde hela. 
hämta (verb)	Vi följde med honom tillbaka till Karlskoga och hämtade vår egen bil och sedan åkte vi hem igen. 
vild (adjective)	Nu finns inte så mycket vild lax så vi äter ofta odlad lax från Norge. 
hämta sig (vbm)	När jag inte kunde sluta, ringde min tränare efter pappa som kom och hämtade mig. 
vildgås (noun)	jag sett vildgässens sträck under kvällande sky. 
hämtmat (noun)	Det finns god hämtmat, men det blir tråkigt efter ett tag. 
plugghäst (noun)	Jag var en riktig plugghäst i skolan. 
händig (adjective)	De fick gamla möbler från vänner och släktingar, och Tobias, som är händig, målade och reparerade dem. 
villa (noun)	Hassan vill köpa hus, en liten villa, men Linda vill vänta med det. 
plusgrad (noun)	Det är 15 plusgrader och sol. 
hänga upp (vbm)	Senare, när jag hängde upp mina våta kläder, hittade jag glasögonen i ena byxfickan. 
villkor (noun)	HANNA: Ja, men bara på ett villkor. 
hänsynsfull (adjective)	Hon måste vara snäll och hänsynsfull och hon får inte svära. 
här och där (abm)	Ekorren har också grävt ner eller gömt undan ätbara ting både här och där. 
härifrån (adverb)	De har två barn, mina barnbarn, men de bor långt härifrån, så jag träffar inte dem så ofta. 
härlig (adjective)	Det är en härlig vårdag. 
polcirkel (noun)	Då gjorde japanska konstnärer en utställning med iskonst i Jukkasjärvi, 20 mil norr om polcirkeln. 
hästgård (noun)	Susanne: Titta här, hästgård femton mil norr om Uppsala. 
hål (noun)	Det är ett stort hål här i framtanden. 
håll (noun)	Ät det här hållet. 
politik (noun)	Jag blev mer och mer intresserad av politik, och 1964 blev jag ordförande i verkstadsklubben på jobbet. 
hålla andan (vbm)	Alla håller andan när de läser: 
politisk (adjective)	Den politiska makten har regeringen och parlamentet, som i Sverige heter riksdagen. 
polkagris (noun)	Som minne av bröllopsresan har Sofia sparat en jättestor polkagris. 
hålla handen (vbm)	De pratar med varandra och dansar med varandra och håller varandra i handen hela kvällen. 
vintersemester (noun)	Akinori måste planera sin vintersemester. 
vinäger (noun)	Sillen äter vi ofta inlagd i ättika (svensk vinäger), salt och socker. 
hålla med (vbm)	Gösta: Jo, det håller jag med om. 
hålla på (vbm)	Håller vi på att få ett neutralt pronomen av tysk och fransk modell? 
hålla sig (vbm)	De håller sig borta från ytterligheterna genom att söka medelvägar, genom att vara lagom. 
popsångare (noun)	Jag ska bli kändis, popsångare eller skådespelare, som Brad Pitt. 
populär (adjective)	Det populäraste bilmärket i Sverige är Volvo. 
port (noun)	Han parkerar bilen utanför porten och bär tillsammans med en kamrat upp allting och ställer det i korridoren. 
portion (noun)	Daniel äter minst två stora portioner. 
hår (noun)	Äntligen är skoldagen slut, och eleverna får gå hem, många fortfarande med glitter i håret. 
portmonnä (noun)	Har vi allting nu ?Är det där din portmonnä? 
hård (adjective)	På senare tid har gå ut och gå blivit sport och hård träning. 
hårdost (noun)	— Vill du ha en hårdost eller en dessertost? 
hårfrisörska (noun)	På gymnasiet kan man välja att studera till ett yrke, som t ex kock, elektriker, hårfrisörska eller något annat. 
possessiv (adjective)	Den handlar bara om possessiva pronomen! 
visning (noun)	Det är mycket folk på visningen. 
hårnål (noun)	Det blev stopp i bränsleledningen men Bertha rensade den med sin hårnål. 
postorder (noun)	Där sålde han billiga möbler per postorder. 
visum (noun)	De måste söka visum, de måste ha en inbjudan, de måste ha någon som garanterar deras uppehälle under besöket. 
höger (adjective)	Det blöder från höger ögonbryn men Klara gråter inte, fastän det gör mycket ont. 
höger (noun)	Till höger ser vi också kungen, men här är han bara ett par månader gammal. 
potatisgratäng (noun)	Patrik: Och jag tar oxfilé med kryddsmör och potatisgratäng. 
vitamin (noun)	Vid brist på vitamin D kan skelettet lakas ur och benskörhet eller benuppmjukning kan bli följden. 
högertrafik (noun)	Men 1967 bytte vi till högertrafik ändå. 
potatismos (noun)	Strömmingen äter vi ofta stekt med potatismos. 
vitlök (noun)	Disa: Nej, ät vitlök i stället! 
vitpeppar (noun)	1 1/2 kryddmått svart- eller vitpeppar 
vitrandig (adjective)	Hennes röd- och vitrandiga polkagrisar som hon tillverkade i Gränna blev mycket populära. 
högskola (noun)	De ger en bred basutbildning och behörighet att studera på universitet eller högskola. 
praktik (noun)	Sedan ska jag göra min praktik här. 
högstadium (noun)	Efter sex år i folkskolan (nu säger man grundskolan) började jag i realskolan (idag heter det högstadiet). 
vokal (noun)	Lyssna efter långa vokaler och konsonanter. 
praktisk (adjective)	Praktiskt och praktiskt förresten, träskor är kanske inte särskilt praktiskt för en polis. 
högtalare (noun)	Skivstången lägger han under sängen och högtalarna ställer han på golvet. 
höja (verb)	Jag hoppas att vi får många barn för det höjer verkligen livskvaliteten. 
precis (adverb)	I USA är det precis tvärtom. 
höjdpunkt (noun)	Semestern i Italien är årets höjdpunkt. 
höjning (noun)	Vi har väntat länge på en höjning. 
höns (noun)	De har djur istället, t.ex. kor, svin, får, höns och kycklingar. 
vrida (verb)	När hon vred på kranen kom öl i stället för vatten. 
preposition (noun)	Ska det vara någon preposition? 
vuxen (adjective)	Men vi vuxna människor måste kväva våra gäspningar och kontrollera vår sömnighet. 
presentera (verb)	På den temperaturskala som han presenterade var vattnets kokpunkt 0 °C och fryspunkten 100 °C. 
president (noun)	Finland och Island är republiker och har en president som statschef. 
pressa (verb)	Häxornas bekännelser pressades ibland fram under stryk och tvång. 
väcka (verb)	Pippi väckte genast starka känslor hos de vuxna. 
höst (noun)	Varje höst är det älgjakt i Sverige. 
väderkarta (noun)	Har du väderkartan i din del? 
höstlov (noun)	Man har jullov och sommarlov men också sportlov, påsklov och höstlov. 
höststorm (noun)	Jag sett vårarna gry, jag hört höststormar gny, 
prins (noun)	Jag var prins Mio och vi slogs mot den grymme riddar Kato. 
väga (verb)	Då vägde hon bara 3,2 kilo och var liten som en docka. 
prinsessa (noun)	Kungen har fyra systrar, prinsessorna Margaretha, Birgitta, Desirée och Christina. 
prisceremoni (noun)	Teve sänder både från prisceremonin och festen efteråt, och i många länder följer man evenemanget med stort intresse. 
pristagare (noun)	Hur mycket pengar får pristagarna? 
privat (adjective)	På en privat rumsförmedling 
problem (noun)	Ett av de många problemen är den svenska kvinnan. 
produkt (noun)	Svenska Prylbolaget vill kanske köpa våra produkter. 
professionell (adjective)	Nej, den där för 650 kronor köper alla professionella fotografer. 
väldig (adjective)	Han var väldig, med stort, rött skägg och blixtrande ögon, lättretad och fruktansvärt stark. 
programledare (noun)	Jag vill bli programledare. 
prospekt (noun)	Mäklaren står i dörren och hälsar välkommen och delar ut prospekt till alla som kommer. 
pronomen (noun)	Den handlar bara om possessiva pronomen! 
protein (noun)	Då får du vitaminer, proteiner och lagom med kalorier. 
välkomna (verb)	Då är ni välkomna den andra november klockan halv sju. 
prov (noun)	Jag ska ta några prover på dig. 
prova (verb)	Det skulle du prova. 
välling (noun)	När hon vaknar måste jag stiga upp med en gång och sätta på välling. 
prägel (noun)	Artisten Cornelis Vreeswijk satte med sin mycket personliga stil sin prägel på den svenska viskonsten. 
präst (noun)	Reser vi till prästen? 
pryl (noun)	Kläderna hänger han in i garderoben och några andra prylar stoppar han in i skåpen. 
pröva (verb)	Hon tänker pröva lyckan och köpa en lott i Chokladlotteriet. 
psalmvers (noun)	Han åt en smörgås till mellanmål, och sedan gjorde han läxorna läsning, skrivning eller en psalmvers. 
vända sig (vbm)	Men man vänder sig också till andra personer. 
publikstöd (noun)	Trots bra publikstöd slutade matchen oavgjort. 
punkt (noun)	På så sätt kan man räkna ut hur långt det är från en punkt till en annan. 
puss (noun)	Stora pussar och kramar! 
vänja sig (vbm)	Men vi vande oss fort och är man bara sig själv så blir man snabbt en i gänget. 
punktlig (adjective)	Fatoush skyndade sig, för hon vet att svenskar är mycket punktliga. 
vänster (noun)	Och sväng till vänster där framme! 
vänsterparti (noun)	Vänsterpartiet (v) är ett socialistiskt parti, som vill avskaffa vänster kapitalismen och klassamhället. 
pytt (noun)	Jag gillar också pytt i panna och biff med lök. 
vänstertrafik (noun)	53 procent röstade, av dem ville 83 procent behålla vänstertrafiken! 
pärla (noun)	Här har vi ett med pärlor från Miyamoto! 
på allas läppar (jjm)	Nobelpriset och Sverige är på allas läppar! 
väntrum (noun)	Väntrummet är ganska fullt, så Daniel tar av sig jackan och sätter sig ner. 
värd (adjective)	Det är förskräckligt dyrt men oftast värt priset. 
på gång (jjm)	och svenskt kulturliv och går igenom programmet gång på gång. 
på köpet (abm)	Och så får du en film på köpet! 
på rad (abm)	Jag drömde om en jättesal, där statsmän satt på rad 
värdinna (noun)	ska du ta bort pappret på blommorna innan du ger dem till värdinnan. 
på stället (abm)	Han har bytt namn på stället också. 
på så sätt (abm)	På så sätt * sparar de pengar. 
värk (noun)	Andra anledningar till att man vänder sig till Hälsohuset kan vara smärta och värk vanligtvis i rygg eller nacke. 
på topp (jjm)	Ibland är det hårt att ligga på topp! 
värld (noun)	Vi har ju numera tillgång till bokstavligen hela världen varje språk har åtminstone någon representant i Sverige. 
på väg (jjm)	Kanske är vi på väg att frigöra oss från att alltid vara lagom och att inte sticka upp. 
påsk (noun)	B: Kan du inte skriva till honom och säga att jag inte har tid i påsk. 
världsdel (noun)	Det är en världsdel långt borta. 
påse (noun)	Vill du ha en påse också? 
påve (noun)	Vatikanen använde det i sin propaganda för katolicismen, och påven behandlade henne som en mycket viktig person. 
påsklov (noun)	Man har jullov och sommarlov men också sportlov, påsklov och höstlov. 
radhus (noun)	Hon bor ensam i ett radhus utanför stan och kör bil till och från arbetet. 
rad (noun)	Jag drömde om en jättesal, där statsmän satt på rad 
värma upp (vbm)	Vi träffas hemma hos någon av killarna och värmer upp med förfest, sedan drar vi ut på stan. 
raka sig (vbm)	Han duschade och tvättade sig extra noga, rakade sig och borstade tänderna. 
raketbas (noun)	Det finns en raketbas, Esrange, i Kiruna också. 
ramla ner (vbm)	KLARA: Vi lekte på dagis och jag ramlade ner från en sten. 
värna (verb)	Värnar om traditioner och privat äganderätt. 
rapa (verb)	När hon har ätit och är mätt måste vi vänta tills hon rapar. 
värnplikt (noun)	Värnplikten gör man inom det militära försvaret, inom armén, marinen eller flygvapnet. 
randig (adjective)	Varför är de randiga? 
värnpliktig (adjective)	Om situationen försämras får vi kalla in värnpliktiga. 
rapport (noun)	Jag har satellittelefon och e-mailcentral uppbyggd med solceller för att kunna lägga in mina rapporter på min sajt, 
raps (noun)	Bönderna odlar t.ex. vete, råg, raps och potatis, och många äger skog också. 
väst (noun)	Hennes blus är också vit, men västen är blå med ljusblåa blommor. 
realskola (noun)	Efter sex år i folkskolan (nu säger man grundskolan) började jag i realskolan (idag heter det högstadiet). 
västkust (noun)	till Öland, västkusten eller Norrland t.ex. 
recept (noun)	Han promenerar med cykeln till apoteket och lämnar in receptet. 
reception (noun)	Om det blir stopp måste du ringa till receptionen. 
receptionist (noun)	RECEPTIONISTEN: Då går det inte den här veckan. 
reda (verb)	medan storkarna redde sitt bo. 
växa (verb)	Den miljö vi växer upp i, människor vi möter under vägen, och slumpen. 
redovisning (noun)	Jag försöker nämligen läsa en kurs i redovisning. 
växel (noun)	Växeln: Svenska Prylbolaget, godmiddag! 
reform (noun)	vill ha ett fritt näringsliv, men också sociala reformer. 
regering (noun)	Midsommar, Lucia, valborgsmässoafton, första maj, kungen, drottningen, riksdagen, regeringen, demokrati, Ingmar Bergman, Björn Borg, Greta Garbo, Birgit Nilsson. 
regeringsparti (noun)	Det fick 36,4 procent av rösterna i valet 1998 och är regeringsparti. 
rejäl (adjective)	Den har ett rejält gryt, djupa hålor i marken. 
våffeldag (noun)	Äter våfflor på våffeldagen. 
reklamannons (noun)	Läs rubriker i tidningen och reklamannonser på stan. 
våffla (noun)	Äter våfflor på våffeldagen. 
våldsam (adjective)	Jag sliter opp papperet med våldsam fart, och jag ser framför mig den allra vackraste lilla bok, en sagobok. 
rektor (noun)	Rektorn skriker att vi ska stanna där vi är och ett par lärare springer tillbaka in i skolbyggnaden. 
våning (noun)	De åker hiss upp läraren bor på tionde våningen. 
religiös (adjective)	Hennes böcker utgår ofta från religiösa motiv. 
våningsplan (noun)	Våningsplan 2 av 4 
relation (noun)	I själva verket varierar relationerna också inom denna cirkel på 150 personer. 
vår (noun)	Jag sett vårarna gry, jag hört höststormar gny, 
vårarbete (noun)	Det kommer att dröja innan vi kan sätta igång med vårarbetet i trädgården. 
ren (adjective)	Sverige det är rena gator, gröna parker, rika naturtillgångar: skogar, järn, älvar. 
ren (noun)	Det fanns också, många, renar. 
renovera (verb)	Han vill renovera lokalen och med Jonas Åberg. 
renoveringsobjekt (noun)	De kan vara nyrenoverade eller renoveringsobjekt. 
vårda (verb)	Andra tillbringar varje ledig stund med att laga och vårda bilen. 
vårdag (noun)	Det är en härlig vårdag. 
repetition (noun)	En kväll när Lisa är på väg hem från en repetition, stannar hon vid 
vårlig (adjective)	Hans syster Ann-Britt tittar samtidigt på fåglar på ett vårligt Öland. 
reparera (verb)	De fick gamla möbler från vänner och släktingar, och Tobias, som är händig, målade och reparerade dem. 
repetera (verb)	Vi har repeterat i nio timmar i dag. 
resa sig (vbm)	så skrev de på ett konvolut och reste sig och sa: 
representera (verb)	Där sitter 349 riksdagsmän, som representerar olika politiska partier. 
vårtermin (noun)	Vårterminen varar till den nionde- tionde juni. 
vårvisa (noun)	Man tänder eldar och sjunger vårvisor. 
republik (noun)	Finland och Island är republiker och har en president som statschef. 
wc (noun)	Ett badrum/wc med badkar, tvättställ och kakel samt ett WC med toalett, tvättställ och kakel. 
whisky (noun)	Robban: Nej, drick ett glas whisky! 
rest (noun)	Resten ligger någonstans mittemellan. 
resultat (noun)	De flesta väljer att spela på hästar och andra spel där man får ett snabbt resultat. 
ytterlig (adjective)	Kvällen går och Selma får ytterligare sysaker 
äga (verb)	Ofta ägs de av utländska investerare eller så har flera företag gått samman. 
äga rum (vbm)	Vansbrosimningen är världens största simtävling och äger alltid rum andra söndagen i juli. 
äganderätt (noun)	Värnar om traditioner och privat äganderätt. 
ägare (noun)	Ägaren tänker vara borta i två år. 
zonterapi (noun)	Just nu lär han sig zonterapi, och igår var han hemma hos mig och övade sig på mig. 
älg (noun)	Alla älgar är duktiga simmare. 
äcklig (adjective)	Det finns många som inte följer lagen och det är så äckligt. 
äkta (adjective)	Här har vi ett par äkta guld och diamanter i 18 karat! 
älgjakt (noun)	Varje höst är det älgjakt i Sverige. 
älgkalv (noun)	Älgkalven väger cirka 10 kg när den föds och efter en vecka orkar den springa ifrån en människa. 
älgko (noun)	Varje år i maj-juni föder älgkon en eller två kalvar. 
älgstek (noun)	Till middag äter de älgstek. 
ämne (noun)	Där kan man läsa många olika ämnen och få grundskole- och gymnasiekompetens. 
älgtjur (noun)	Älgen har långa ben och kort hals och älgtjuren har stora horn. 
änka (noun)	Hon var änka och levde ensam med en dotter det var Marie. 
ännu (adverb)	Jag har några gånger varit ordentligt dum, och jag kan ännu rodna av skam när jag tänker på det. 
ändå (adverb)	Man ska då finna, att hur mycket man än har ansträngt sig, kommer språkgranskaren ändå att ändra. 
äng (noun)	Det finns ungefär 80 000 jordbruk på i genomsnitt 34 hektar (340 000 kvadratmeter) åkrar och ängar. 
ärr (noun)	Det kan bli ett fult ärr, om de inte syr. 
ärtsoppa (noun)	En gång i veckan äter han köttbullar, korv, pannkaka och ärtsoppa och fisk av något slag. 
ätt (noun)	Ätten Bernadotte kommer ursprungligen från Frankrike. 
å (noun)	Jonas Ni bor nära ån. 
åka dit (vbm)	Jag har inte varit där på ett tag, men jag skulle gärna vilja åka dit snart. 
ättika (noun)	Sillen äter vi ofta inlagd i ättika (svensk vinäger), salt och socker. 
å (preposition)	Karl å sin sida var orolig, för han trodde att turkarna tänkte lämna ut honom till hans fiender. 
även (adverb)	Men nu har den amerikanska flugan surrat in även i politikernas språk. 
åker (noun)	Det finns ungefär 80 000 jordbruk på i genomsnitt 34 hektar (340 000 kvadratmeter) åkrar och ängar. 
ål (noun)	Jag älskar typisk skånsk mat som sill, ål och spettekaka. 
ålder (noun)	Ålder och kön är de två faktorer som utmärker sensationssökarna mest. 
åra (noun)	Vem kan ro utan åror? 
årstid (noun)	Sverige är ett avlångt land (1 574 km) i norra Europa med olika årstider, ibland nästan samtidigt. 
årskurs (noun)	I de högre årskurserna kan man ha olika lärare i de olika ämnena. 
återkomma (verb)	Det fullständiga resultatet återkommer vi till i morgondagens upplaga. 
återstå (verb)	Om han får låna 750 000 på banken återstår ändå över 130 000 kronor. 
öde (noun)	Bl.a. har han skrivit romanerna Fru Björks öden och äventyr (1990) och En komikers uppväxt (1992). 
öka (verb)	Det är därför bl.a. som blomsterförsäljningen har ökat. 
öga (noun)	Du får egentligen ingen riktigt bra bild av en människa om du ser henne i ögonen. 
öl (noun)	Och den som har druckit några öl vill allra helst prata om sig själv. 
önska (verb)	Först skakar han hand med Sir Malcolm och önskar honom välkommen. 
ögonbryn (noun)	Det blöder från höger ögonbryn men Klara gråter inte, fastän det gör mycket ont. 
öra (noun)	M: Jag tyckte att han hade en häftig ring i örat. 
öre (noun)	Det var ett tungt och smutsigt arbete och jag tjänade bara 50 öre i timmen. 
örhänge (noun)	G: Jag behöver örhängen också! 
östra (adjective)	Den ligger där, i östra Sverige. 
öva (verb)	Just nu lär han sig zonterapi, och igår var han hemma hos mig och övade sig på mig. 
överallt (adverb)	Inne hos Millan är det emellertid ljust och varmt, för det står levande ljus överallt, och det doftar gott. 
överhuvudtaget (adverb)	Ville jag överhuvudtaget göra lumpen? 
övernatta (verb)	Ibland övernattar de på vandrarhem, ibland tältar de. 
överraskning (noun)	De ringer på dörren och läraren öppnar och ser förvånad ut: Nej, men vilken överraskning! 
översättare (noun)	Då ska jag söka jobb som översättare. 
övrig (adjective)	alla de övriga trettioen. 
övning (noun)	Knut: Ja, vi läste lite och diskuterade och skrev några övningar. 
övningsbok (noun)	Skriv inte alltid i övningsboken. 
övningsköra (verb)	Han vill övningsköra, och det får man när man är 16 år. 
